fra;vaccin;jour;n_dose1;n_dose2;n_cum_dose1;n_cum_dose2
FR;1;2020-12-27;20;0;20;0
FR;1;2020-12-28;63;0;83;0
FR;1;2020-12-29;108;0;191;0
FR;1;2020-12-30;119;0;310;0
FR;1;2020-12-31;83;0;393;0
FR;1;2021-01-01;65;0;458;0
FR;1;2021-01-02;76;0;534;0
FR;1;2021-01-03;87;0;621;0
FR;1;2021-01-04;1468;0;2089;0
FR;1;2021-01-05;5378;0;7467;0
FR;1;2021-01-06;11278;0;18745;0
FR;1;2021-01-07;28526;0;47271;0
FR;1;2021-01-08;36035;0;83306;0
FR;1;2021-01-09;10886;0;94192;0
FR;1;2021-01-10;5602;0;99794;0
FR;1;2021-01-11;38841;0;138635;0
FR;1;2021-01-12;60629;0;199264;0
FR;1;2021-01-13;63550;0;262814;0
FR;1;2021-01-14;79494;0;342308;0
FR;1;2021-01-15;66963;0;409271;0
FR;1;2021-01-16;19409;78;428680;78
FR;1;2021-01-17;10450;42;439130;120
FR;1;2021-01-18;81346;163;520476;283
FR;1;2021-01-19;123695;127;644171;410
FR;1;2021-01-20;129877;159;774048;569
FR;1;2021-01-21;149770;135;923818;704
FR;1;2021-01-22;113331;162;1037149;866
FR;1;2021-01-23;36017;50;1073166;916
FR;1;2021-01-24;9249;27;1082415;943
FR;1;2021-01-25;73025;1218;1155440;2161
FR;1;2021-01-26;94894;3110;1250334;5271
FR;1;2021-01-27;102049;5597;1352383;10868
FR;1;2021-01-28;118527;14360;1470910;25228
FR;1;2021-01-29;87686;17293;1558596;42521
FR;1;2021-01-30;27567;4225;1586163;46746
FR;1;2021-01-31;4863;1679;1591026;48425
FR;1;2021-02-01;48160;21128;1639186;69553
FR;1;2021-02-02;66097;34568;1705283;104121
FR;1;2021-02-03;65805;36960;1771088;141081
FR;1;2021-02-04;75567;50057;1846655;191138
FR;1;2021-02-05;62303;45335;1908958;236473
FR;1;2021-02-06;19032;10396;1927990;246869
FR;1;2021-02-07;3436;5041;1931426;251910
FR;1;2021-02-08;35731;45985;1967157;297895
FR;1;2021-02-09;49769;72392;2016926;370287
FR;1;2021-02-10;50786;76646;2067712;446933
FR;1;2021-02-11;62010;99077;2129722;546010
FR;1;2021-02-12;54740;74038;2184462;620048
FR;1;2021-02-13;15106;19270;2199568;639318
FR;1;2021-02-14;3409;7190;2202977;646508
FR;1;2021-02-15;23524;73440;2226501;719948
FR;1;2021-02-16;32075;96865;2258576;816813
FR;1;2021-02-17;34335;98568;2292911;915381
FR;1;2021-02-18;47951;113475;2340862;1028856
FR;1;2021-02-19;44346;86412;2385208;1115268
FR;1;2021-02-20;13008;26919;2398216;1142187
FR;1;2021-02-21;2109;6287;2400325;1148474
FR;1;2021-02-22;23981;69414;2424306;1217888
FR;1;2021-02-23;36508;80365;2460814;1298253
FR;1;2021-02-24;39304;77661;2500118;1375914
FR;1;2021-02-25;48715;87994;2548833;1463908
FR;1;2021-02-26;45964;67886;2594797;1531794
FR;1;2021-02-27;15166;20930;2609963;1552724
FR;1;2021-02-28;3226;4386;2613189;1557110
FR;1;2021-03-01;38663;49029;2651852;1606139
FR;1;2021-03-02;54557;61505;2706409;1667644
FR;1;2021-03-03;59336;60650;2765745;1728294
FR;1;2021-03-04;70902;64894;2836647;1793188
FR;1;2021-03-05;72992;59269;2909639;1852457
FR;1;2021-03-06;81257;16091;2990896;1868548
FR;1;2021-03-07;62946;5422;3053842;1873970
FR;1;2021-03-08;58642;42474;3112484;1916444
FR;1;2021-03-09;84265;48316;3196749;1964760
FR;1;2021-03-10;88778;48064;3285527;2012824
FR;1;2021-03-11;102994;53858;3388521;2066682
FR;1;2021-03-12;101984;45266;3490505;2111948
FR;1;2021-03-13;87477;12720;3577982;2124668
FR;1;2021-03-14;43620;3031;3621602;2127699
FR;1;2021-03-15;93582;29150;3715184;2156849
FR;1;2021-03-16;121730;34905;3836914;2191754
FR;1;2021-03-17;127150;34868;3964064;2226622
FR;1;2021-03-18;140548;39750;4104612;2266372
FR;1;2021-03-19;134003;32912;4238615;2299284
FR;1;2021-03-20;74867;10211;4313482;2309495
FR;1;2021-03-21;25763;2476;4339245;2311971
FR;1;2021-03-22;112781;31188;4452026;2343159
FR;1;2021-03-23;140590;38173;4592616;2381332
FR;1;2021-03-24;139615;38790;4732231;2420122
FR;1;2021-03-25;162392;39617;4894623;2459739
FR;1;2021-03-26;163883;37495;5058506;2497234
FR;1;2021-03-27;109730;15256;5168236;2512490
FR;1;2021-03-28;41702;3624;5209938;2516114
FR;1;2021-03-29;128018;49969;5337956;2566083
FR;1;2021-03-30;165089;63596;5503045;2629679
FR;1;2021-03-31;168202;66913;5671247;2696592
FR;1;2021-04-01;190327;79252;5861574;2775844
FR;1;2021-04-02;161830;84318;6023404;2860162
FR;1;2021-04-03;86967;58184;6110371;2918346
FR;1;2021-04-04;32271;17732;6142642;2936078
FR;1;2021-04-05;42356;10177;6184998;2946255
FR;1;2021-04-06;156764;100887;6341762;3047142
FR;1;2021-04-07;193358;108269;6535120;3155411
FR;1;2021-04-08;217521;112406;6752641;3267817
FR;1;2021-04-09;209955;107518;6962596;3375335
FR;1;2021-04-10;115965;73462;7078561;3448797
FR;1;2021-04-11;40060;30288;7118621;3479085
FR;1;2021-04-12;165665;103796;7284286;3582881
FR;1;2021-04-13;199794;128256;7484080;3711137
FR;1;2021-04-14;203827;122819;7687907;3833956
FR;1;2021-04-15;215825;126758;7903732;3960714
FR;1;2021-04-16;201719;125148;8105451;4085862
FR;1;2021-04-17;120197;67479;8225648;4153341
FR;1;2021-04-18;35001;20992;8260649;4174333
FR;1;2021-04-19;160306;121928;8420955;4296261
FR;1;2021-04-20;184813;148796;8605768;4445057
FR;1;2021-04-21;189436;146750;8795204;4591807
FR;1;2021-04-22;203663;162647;8998867;4754454
FR;1;2021-04-23;193900;156930;9192767;4911384
FR;1;2021-04-24;123800;95506;9316567;5006890
FR;1;2021-04-25;51866;30130;9368433;5037020
FR;1;2021-04-26;175049;138279;9543482;5175299
FR;1;2021-04-27;216466;162008;9759948;5337307
FR;1;2021-04-28;233266;155136;9993214;5492443
FR;1;2021-04-29;262836;160092;10256050;5652535
FR;1;2021-04-30;265269;148176;10521319;5800711
FR;1;2021-05-01;133388;40718;10654707;5841429
FR;1;2021-05-02;79492;28163;10734199;5869592
FR;1;2021-05-03;242979;146547;10977178;6016139
FR;1;2021-05-04;257215;186877;11234393;6203016
FR;1;2021-05-05;272359;184598;11506752;6387614
FR;1;2021-05-06;299024;183068;11805776;6570682
FR;1;2021-05-07;274853;195762;12080629;6766444
FR;1;2021-05-08;172625;48328;12253254;6814772
FR;1;2021-05-09;111982;36232;12365236;6851004
FR;1;2021-05-10;244657;194293;12609893;7045297
FR;1;2021-05-11;307499;211452;12917392;7256749
FR;1;2021-05-12;337351;185959;13254743;7442708
FR;1;2021-05-13;271626;47683;13526369;7490391
FR;1;2021-05-14;354792;128937;13881161;7619328
FR;1;2021-05-15;284283;66172;14165444;7685500
FR;1;2021-05-16;153924;15585;14319368;7701085
FR;2;2020-12-27;0;0;0;0
FR;2;2020-12-28;0;0;0;0
FR;2;2020-12-29;0;0;0;0
FR;2;2020-12-30;0;0;0;0
FR;2;2020-12-31;0;0;0;0
FR;2;2021-01-01;0;0;0;0
FR;2;2021-01-02;0;0;0;0
FR;2;2021-01-03;0;0;0;0
FR;2;2021-01-04;0;0;0;0
FR;2;2021-01-05;0;0;0;0
FR;2;2021-01-06;0;0;0;0
FR;2;2021-01-07;0;0;0;0
FR;2;2021-01-08;0;0;0;0
FR;2;2021-01-09;0;0;0;0
FR;2;2021-01-10;0;0;0;0
FR;2;2021-01-11;0;0;0;0
FR;2;2021-01-12;0;0;0;0
FR;2;2021-01-13;0;0;0;0
FR;2;2021-01-14;143;0;143;0
FR;2;2021-01-15;217;0;360;0
FR;2;2021-01-16;185;0;545;0
FR;2;2021-01-17;3;0;548;0
FR;2;2021-01-18;2902;0;3450;0
FR;2;2021-01-19;4485;0;7935;0
FR;2;2021-01-20;4903;0;12838;0
FR;2;2021-01-21;5065;0;17903;0
FR;2;2021-01-22;4858;0;22761;0
FR;2;2021-01-23;1728;0;24489;0
FR;2;2021-01-24;83;0;24572;0
FR;2;2021-01-25;3633;0;28205;0
FR;2;2021-01-26;3695;0;31900;0
FR;2;2021-01-27;3402;0;35302;0
FR;2;2021-01-28;3479;0;38781;0
FR;2;2021-01-29;3072;0;41853;0
FR;2;2021-01-30;1054;0;42907;0
FR;2;2021-01-31;0;0;42907;0
FR;2;2021-02-01;3247;0;46154;0
FR;2;2021-02-02;4302;0;50456;0
FR;2;2021-02-03;5029;0;55485;0
FR;2;2021-02-04;4724;3;60209;3
FR;2;2021-02-05;4555;6;64764;9
FR;2;2021-02-06;1929;3;66693;12
FR;2;2021-02-07;42;0;66735;12
FR;2;2021-02-08;7415;8;74150;20
FR;2;2021-02-09;8250;15;82400;35
FR;2;2021-02-10;9134;49;91534;84
FR;2;2021-02-11;10048;67;101582;151
FR;2;2021-02-12;9779;238;111361;389
FR;2;2021-02-13;3010;222;114371;611
FR;2;2021-02-14;296;0;114667;611
FR;2;2021-02-15;3356;3067;118023;3678
FR;2;2021-02-16;4901;3881;122924;7559
FR;2;2021-02-17;4098;4403;127022;11962
FR;2;2021-02-18;5228;5087;132250;17049
FR;2;2021-02-19;5119;4323;137369;21372
FR;2;2021-02-20;1763;1509;139132;22881
FR;2;2021-02-21;197;86;139329;22967
FR;2;2021-02-22;3511;3723;142840;26690
FR;2;2021-02-23;4801;3693;147641;30383
FR;2;2021-02-24;4738;3468;152379;33851
FR;2;2021-02-25;5289;3426;157668;37277
FR;2;2021-02-26;4193;3125;161861;40402
FR;2;2021-02-27;1500;1042;163361;41444
FR;2;2021-02-28;99;28;163460;41472
FR;2;2021-03-01;4954;3764;168414;45236
FR;2;2021-03-02;6300;4728;174714;49964
FR;2;2021-03-03;6238;4882;180952;54846
FR;2;2021-03-04;8065;3967;189017;58813
FR;2;2021-03-05;7765;4059;196782;62872
FR;2;2021-03-06;4619;1682;201401;64554
FR;2;2021-03-07;2283;29;203684;64583
FR;2;2021-03-08;3977;8309;207661;72892
FR;2;2021-03-09;7263;8429;214924;81321
FR;2;2021-03-10;6848;9108;221772;90429
FR;2;2021-03-11;9039;9208;230811;99637
FR;2;2021-03-12;7699;8169;238510;107806
FR;2;2021-03-13;9863;2510;248373;110316
FR;2;2021-03-14;4752;400;253125;110716
FR;2;2021-03-15;10627;3482;263752;114198
FR;2;2021-03-16;16430;4621;280182;118819
FR;2;2021-03-17;19882;3952;300064;122771
FR;2;2021-03-18;22937;4910;323001;127681
FR;2;2021-03-19;22868;4536;345869;132217
FR;2;2021-03-20;25137;1540;371006;133757
FR;2;2021-03-21;17467;147;388473;133904
FR;2;2021-03-22;17371;3078;405844;136982
FR;2;2021-03-23;22253;4183;428097;141165
FR;2;2021-03-24;23514;4988;451611;146153
FR;2;2021-03-25;26242;5020;477853;151173
FR;2;2021-03-26;26564;4260;504417;155433
FR;2;2021-03-27;15631;1309;520048;156742
FR;2;2021-03-28;10391;94;530439;156836
FR;2;2021-03-29;18618;4280;549057;161116
FR;2;2021-03-30;24146;6002;573203;167118
FR;2;2021-03-31;28036;5956;601239;173074
FR;2;2021-04-01;33800;8495;635039;181569
FR;2;2021-04-02;29372;7661;664411;189230
FR;2;2021-04-03;16716;3582;681127;192812
FR;2;2021-04-04;9152;918;690279;193730
FR;2;2021-04-05;12112;811;702391;194541
FR;2;2021-04-06;26642;6934;729033;201475
FR;2;2021-04-07;30419;7174;759452;208649
FR;2;2021-04-08;36449;8817;795901;217466
FR;2;2021-04-09;33319;8601;829220;226067
FR;2;2021-04-10;19428;8968;848648;235035
FR;2;2021-04-11;7808;4271;856456;239306
FR;2;2021-04-12;16754;11254;873210;250560
FR;2;2021-04-13;19007;16426;892217;266986
FR;2;2021-04-14;17568;16284;909785;283270
FR;2;2021-04-15;21772;20757;931557;304027
FR;2;2021-04-16;20260;20073;951817;324100
FR;2;2021-04-17;12978;22462;964795;346562
FR;2;2021-04-18;5767;14405;970562;360967
FR;2;2021-04-19;16381;16261;986943;377228
FR;2;2021-04-20;18866;21595;1005809;398823
FR;2;2021-04-21;18315;21665;1024124;420488
FR;2;2021-04-22;23156;24861;1047280;445349
FR;2;2021-04-23;23984;25346;1071264;470695
FR;2;2021-04-24;24953;15111;1096217;485806
FR;2;2021-04-25;9407;8589;1105624;494395
FR;2;2021-04-26;16584;17194;1122208;511589
FR;2;2021-04-27;18866;24305;1141074;535894
FR;2;2021-04-28;21458;26189;1162532;562083
FR;2;2021-04-29;24702;30136;1187234;592219
FR;2;2021-04-30;24955;27782;1212189;620001
FR;2;2021-05-01;14747;9863;1226936;629864
FR;2;2021-05-02;6475;9184;1233411;639048
FR;2;2021-05-03;19011;19327;1252422;658375
FR;2;2021-05-04;17840;29055;1270262;687430
FR;2;2021-05-05;17851;29417;1288113;716847
FR;2;2021-05-06;23055;35293;1311168;752140
FR;2;2021-05-07;23525;33243;1334693;785383
FR;2;2021-05-08;19253;9703;1353946;795086
FR;2;2021-05-09;12893;7894;1366839;802980
FR;2;2021-05-10;32024;22221;1398863;825201
FR;2;2021-05-11;42204;21078;1441067;846279
FR;2;2021-05-12;47094;19907;1488161;866186
FR;2;2021-05-13;50328;5770;1538489;871956
FR;2;2021-05-14;59826;12954;1598315;884910
FR;2;2021-05-15;64759;7155;1663074;892065
FR;2;2021-05-16;42881;2575;1705955;894640
FR;3;2020-12-27;0;0;0;0
FR;3;2020-12-28;0;0;0;0
FR;3;2020-12-29;0;0;0;0
FR;3;2020-12-30;0;0;0;0
FR;3;2020-12-31;0;0;0;0
FR;3;2021-01-01;0;0;0;0
FR;3;2021-01-02;0;0;0;0
FR;3;2021-01-03;0;0;0;0
FR;3;2021-01-04;0;0;0;0
FR;3;2021-01-05;0;0;0;0
FR;3;2021-01-06;0;0;0;0
FR;3;2021-01-07;0;0;0;0
FR;3;2021-01-08;0;0;0;0
FR;3;2021-01-09;0;0;0;0
FR;3;2021-01-10;0;0;0;0
FR;3;2021-01-11;0;0;0;0
FR;3;2021-01-12;0;0;0;0
FR;3;2021-01-13;0;0;0;0
FR;3;2021-01-14;0;0;0;0
FR;3;2021-01-15;0;0;0;0
FR;3;2021-01-16;0;0;0;0
FR;3;2021-01-17;0;0;0;0
FR;3;2021-01-18;0;0;0;0
FR;3;2021-01-19;0;0;0;0
FR;3;2021-01-20;0;0;0;0
FR;3;2021-01-21;0;0;0;0
FR;3;2021-01-22;0;0;0;0
FR;3;2021-01-23;0;0;0;0
FR;3;2021-01-24;0;0;0;0
FR;3;2021-01-25;0;0;0;0
FR;3;2021-01-26;0;0;0;0
FR;3;2021-01-27;0;0;0;0
FR;3;2021-01-28;0;0;0;0
FR;3;2021-01-29;0;0;0;0
FR;3;2021-01-30;0;0;0;0
FR;3;2021-01-31;0;0;0;0
FR;3;2021-02-01;0;0;0;0
FR;3;2021-02-02;0;0;0;0
FR;3;2021-02-03;0;0;0;0
FR;3;2021-02-04;0;0;0;0
FR;3;2021-02-05;0;0;0;0
FR;3;2021-02-06;299;0;299;0
FR;3;2021-02-07;1348;0;1647;0
FR;3;2021-02-08;2627;0;4274;0
FR;3;2021-02-09;6620;0;10894;0
FR;3;2021-02-10;9184;0;20078;0
FR;3;2021-02-11;13277;0;33355;0
FR;3;2021-02-12;12983;0;46338;0
FR;3;2021-02-13;3482;0;49820;0
FR;3;2021-02-14;859;0;50679;0
FR;3;2021-02-15;9998;0;60677;0
FR;3;2021-02-16;12112;0;72789;0
FR;3;2021-02-17;10767;0;83556;0
FR;3;2021-02-18;14447;0;98003;0
FR;3;2021-02-19;14012;0;112015;0
FR;3;2021-02-20;3142;0;115157;0
FR;3;2021-02-21;537;0;115694;0
FR;3;2021-02-22;8785;0;124479;0
FR;3;2021-02-23;10957;0;135436;0
FR;3;2021-02-24;13763;0;149199;0
FR;3;2021-02-25;43895;0;193094;0
FR;3;2021-02-26;60925;0;254019;0
FR;3;2021-02-27;34173;8;288192;8
FR;3;2021-02-28;2313;0;290505;8
FR;3;2021-03-01;19497;11;310002;19
FR;3;2021-03-02;37865;13;347867;32
FR;3;2021-03-03;47178;19;395045;51
FR;3;2021-03-04;79788;20;474833;71
FR;3;2021-03-05;115586;65;590419;136
FR;3;2021-03-06;116987;51;707406;187
FR;3;2021-03-07;53762;30;761168;217
FR;3;2021-03-08;41494;25;802662;242
FR;3;2021-03-09;77030;33;879692;275
FR;3;2021-03-10;78827;43;958519;318
FR;3;2021-03-11;125705;52;1084224;370
FR;3;2021-03-12;179439;71;1263663;441
FR;3;2021-03-13;129415;54;1393078;495
FR;3;2021-03-14;13593;6;1406671;501
FR;3;2021-03-15;50707;41;1457378;542
FR;3;2021-03-16;844;15;1458222;557
FR;3;2021-03-17;563;6;1458785;563
FR;3;2021-03-18;1088;4;1459873;567
FR;3;2021-03-19;68847;38;1528720;605
FR;3;2021-03-20;64024;36;1592744;641
FR;3;2021-03-21;5446;5;1598190;646
FR;3;2021-03-22;36391;34;1634581;680
FR;3;2021-03-23;83017;50;1717598;730
FR;3;2021-03-24;89241;91;1806839;821
FR;3;2021-03-25;147583;117;1954422;938
FR;3;2021-03-26;163073;156;2117495;1094
FR;3;2021-03-27;66992;88;2184487;1182
FR;3;2021-03-28;6137;19;2190624;1201
FR;3;2021-03-29;53163;61;2243787;1262
FR;3;2021-03-30;91775;88;2335562;1350
FR;3;2021-03-31;62179;82;2397741;1432
FR;3;2021-04-01;84432;105;2482173;1537
FR;3;2021-04-02;85552;148;2567725;1685
FR;3;2021-04-03;35138;110;2602863;1795
FR;3;2021-04-04;3372;15;2606235;1810
FR;3;2021-04-05;4201;21;2610436;1831
FR;3;2021-04-06;28825;76;2639261;1907
FR;3;2021-04-07;31454;60;2670715;1967
FR;3;2021-04-08;77357;235;2748072;2202
FR;3;2021-04-09;159565;411;2907637;2613
FR;3;2021-04-10;74337;333;2981974;2946
FR;3;2021-04-11;7001;44;2988975;2990
FR;3;2021-04-12;50419;197;3039394;3187
FR;3;2021-04-13;84928;316;3124322;3503
FR;3;2021-04-14;66411;342;3190733;3845
FR;3;2021-04-15;91511;371;3282244;4216
FR;3;2021-04-16;110844;574;3393088;4790
FR;3;2021-04-17;52149;337;3445237;5127
FR;3;2021-04-18;9417;35;3454654;5162
FR;3;2021-04-19;24371;239;3479025;5401
FR;3;2021-04-20;44704;399;3523729;5800
FR;3;2021-04-21;37952;458;3561681;6258
FR;3;2021-04-22;53516;794;3615197;7052
FR;3;2021-04-23;69239;1031;3684436;8083
FR;3;2021-04-24;36455;988;3720891;9071
FR;3;2021-04-25;5894;168;3726785;9239
FR;3;2021-04-26;19064;667;3745849;9906
FR;3;2021-04-27;33647;1246;3779496;11152
FR;3;2021-04-28;28178;1925;3807674;13077
FR;3;2021-04-29;44431;5958;3852105;19035
FR;3;2021-04-30;54437;8932;3906542;27967
FR;3;2021-05-01;9136;1968;3915678;29935
FR;3;2021-05-02;2798;500;3918476;30435
FR;3;2021-05-03;12462;3880;3930938;34315
FR;3;2021-05-04;22340;8454;3953278;42769
FR;3;2021-05-05;17907;10575;3971185;53344
FR;3;2021-05-06;33764;20907;4004949;74251
FR;3;2021-05-07;43103;28407;4048052;102658
FR;3;2021-05-08;6206;8911;4054258;111569
FR;3;2021-05-09;1546;2657;4055804;114226
FR;3;2021-05-10;14254;12561;4070058;126787
FR;3;2021-05-11;26218;25740;4096276;152527
FR;3;2021-05-12;16398;27452;4112674;179979
FR;3;2021-05-13;1923;3479;4114597;183458
FR;3;2021-05-14;13775;25745;4128372;209203
FR;3;2021-05-15;6699;20734;4135071;229937
FR;3;2021-05-16;764;2683;4135835;232620
FR;4;2020-12-27;0;0;0;0
FR;4;2020-12-28;0;0;0;0
FR;4;2020-12-29;0;0;0;0
FR;4;2020-12-30;0;0;0;0
FR;4;2020-12-31;0;0;0;0
FR;4;2021-01-01;0;0;0;0
FR;4;2021-01-02;0;0;0;0
FR;4;2021-01-03;0;0;0;0
FR;4;2021-01-04;0;0;0;0
FR;4;2021-01-05;0;0;0;0
FR;4;2021-01-06;0;0;0;0
FR;4;2021-01-07;0;0;0;0
FR;4;2021-01-08;0;0;0;0
FR;4;2021-01-09;0;0;0;0
FR;4;2021-01-10;0;0;0;0
FR;4;2021-01-11;0;0;0;0
FR;4;2021-01-12;0;0;0;0
FR;4;2021-01-13;0;0;0;0
FR;4;2021-01-14;0;0;0;0
FR;4;2021-01-15;0;0;0;0
FR;4;2021-01-16;0;0;0;0
FR;4;2021-01-17;0;0;0;0
FR;4;2021-01-18;0;0;0;0
FR;4;2021-01-19;0;0;0;0
FR;4;2021-01-20;0;0;0;0
FR;4;2021-01-21;0;0;0;0
FR;4;2021-01-22;0;0;0;0
FR;4;2021-01-23;0;0;0;0
FR;4;2021-01-24;0;0;0;0
FR;4;2021-01-25;0;0;0;0
FR;4;2021-01-26;0;0;0;0
FR;4;2021-01-27;0;0;0;0
FR;4;2021-01-28;0;0;0;0
FR;4;2021-01-29;0;0;0;0
FR;4;2021-01-30;0;0;0;0
FR;4;2021-01-31;0;0;0;0
FR;4;2021-02-01;0;0;0;0
FR;4;2021-02-02;0;0;0;0
FR;4;2021-02-03;0;0;0;0
FR;4;2021-02-04;0;0;0;0
FR;4;2021-02-05;0;0;0;0
FR;4;2021-02-06;0;0;0;0
FR;4;2021-02-07;0;0;0;0
FR;4;2021-02-08;0;0;0;0
FR;4;2021-02-09;0;0;0;0
FR;4;2021-02-10;0;0;0;0
FR;4;2021-02-11;0;0;0;0
FR;4;2021-02-12;0;0;0;0
FR;4;2021-02-13;0;0;0;0
FR;4;2021-02-14;0;0;0;0
FR;4;2021-02-15;0;0;0;0
FR;4;2021-02-16;0;0;0;0
FR;4;2021-02-17;0;0;0;0
FR;4;2021-02-18;0;0;0;0
FR;4;2021-02-19;0;0;0;0
FR;4;2021-02-20;0;0;0;0
FR;4;2021-02-21;0;0;0;0
FR;4;2021-02-22;0;0;0;0
FR;4;2021-02-23;0;0;0;0
FR;4;2021-02-24;0;0;0;0
FR;4;2021-02-25;0;0;0;0
FR;4;2021-02-26;0;0;0;0
FR;4;2021-02-27;0;0;0;0
FR;4;2021-02-28;0;0;0;0
FR;4;2021-03-01;0;0;0;0
FR;4;2021-03-02;0;0;0;0
FR;4;2021-03-03;0;0;0;0
FR;4;2021-03-04;0;0;0;0
FR;4;2021-03-05;0;0;0;0
FR;4;2021-03-06;0;0;0;0
FR;4;2021-03-07;0;0;0;0
FR;4;2021-03-08;0;0;0;0
FR;4;2021-03-09;0;0;0;0
FR;4;2021-03-10;0;0;0;0
FR;4;2021-03-11;0;0;0;0
FR;4;2021-03-12;0;0;0;0
FR;4;2021-03-13;0;0;0;0
FR;4;2021-03-14;0;0;0;0
FR;4;2021-03-15;0;0;0;0
FR;4;2021-03-16;0;0;0;0
FR;4;2021-03-17;0;0;0;0
FR;4;2021-03-18;0;0;0;0
FR;4;2021-03-19;0;0;0;0
FR;4;2021-03-20;0;0;0;0
FR;4;2021-03-21;0;0;0;0
FR;4;2021-03-22;0;0;0;0
FR;4;2021-03-23;0;0;0;0
FR;4;2021-03-24;0;0;0;0
FR;4;2021-03-25;0;0;0;0
FR;4;2021-03-26;0;0;0;0
FR;4;2021-03-27;0;0;0;0
FR;4;2021-03-28;0;0;0;0
FR;4;2021-03-29;0;0;0;0
FR;4;2021-03-30;0;0;0;0
FR;4;2021-03-31;0;0;0;0
FR;4;2021-04-01;0;0;0;0
FR;4;2021-04-02;0;0;0;0
FR;4;2021-04-03;0;0;0;0
FR;4;2021-04-04;0;0;0;0
FR;4;2021-04-05;0;0;0;0
FR;4;2021-04-06;0;0;0;0
FR;4;2021-04-07;0;0;0;0
FR;4;2021-04-08;0;0;0;0
FR;4;2021-04-09;0;0;0;0
FR;4;2021-04-10;0;0;0;0
FR;4;2021-04-11;0;0;0;0
FR;4;2021-04-12;0;0;0;0
FR;4;2021-04-13;0;0;0;0
FR;4;2021-04-14;0;0;0;0
FR;4;2021-04-15;0;0;0;0
FR;4;2021-04-16;0;0;0;0
FR;4;2021-04-17;0;0;0;0
FR;4;2021-04-18;0;0;0;0
FR;4;2021-04-19;0;0;0;0
FR;4;2021-04-20;0;0;0;0
FR;4;2021-04-21;0;0;0;0
FR;4;2021-04-22;0;0;0;0
FR;4;2021-04-23;505;0;505;0
FR;4;2021-04-24;1553;0;2058;0
FR;4;2021-04-25;117;0;2175;0
FR;4;2021-04-26;2818;0;4993;0
FR;4;2021-04-27;9349;3;14342;3
FR;4;2021-04-28;9738;3;24080;6
FR;4;2021-04-29;15841;7;39921;13
FR;4;2021-04-30;19025;7;58946;20
FR;4;2021-05-01;1874;5;60820;25
FR;4;2021-05-02;432;0;61252;25
FR;4;2021-05-03;4894;1;66146;26
FR;4;2021-05-04;8235;8;74381;34
FR;4;2021-05-05;5971;7;80352;41
FR;4;2021-05-06;11208;13;91560;54
FR;4;2021-05-07;18808;10;110368;64
FR;4;2021-05-08;2219;4;112587;68
FR;4;2021-05-09;625;2;113212;70
FR;4;2021-05-10;7020;11;120232;81
FR;4;2021-05-11;13993;12;134225;93
FR;4;2021-05-12;9783;13;144008;106
FR;4;2021-05-13;1409;3;145417;109
FR;4;2021-05-14;7422;8;152839;117
FR;4;2021-05-15;3465;9;156304;126
FR;4;2021-05-16;326;1;156630;127
FR;0;2020-12-27;20;0;20;0
FR;0;2020-12-28;63;0;83;0
FR;0;2020-12-29;108;0;191;0
FR;0;2020-12-30;119;0;310;0
FR;0;2020-12-31;83;0;393;0
FR;0;2021-01-01;65;0;458;0
FR;0;2021-01-02;76;0;534;0
FR;0;2021-01-03;87;0;621;0
FR;0;2021-01-04;1468;0;2089;0
FR;0;2021-01-05;5378;0;7467;0
FR;0;2021-01-06;11278;0;18745;0
FR;0;2021-01-07;28526;0;47271;0
FR;0;2021-01-08;36035;0;83306;0
FR;0;2021-01-09;10886;0;94192;0
FR;0;2021-01-10;5602;0;99794;0
FR;0;2021-01-11;38841;0;138635;0
FR;0;2021-01-12;60629;0;199264;0
FR;0;2021-01-13;63550;0;262814;0
FR;0;2021-01-14;79637;0;342451;0
FR;0;2021-01-15;67180;0;409631;0
FR;0;2021-01-16;19594;78;429225;78
FR;0;2021-01-17;10453;42;439678;120
FR;0;2021-01-18;84248;163;523926;283
FR;0;2021-01-19;128180;127;652106;410
FR;0;2021-01-20;134780;159;786886;569
FR;0;2021-01-21;154835;135;941721;704
FR;0;2021-01-22;118189;162;1059910;866
FR;0;2021-01-23;37745;50;1097655;916
FR;0;2021-01-24;9332;27;1106987;943
FR;0;2021-01-25;76658;1218;1183645;2161
FR;0;2021-01-26;98589;3110;1282234;5271
FR;0;2021-01-27;105451;5597;1387685;10868
FR;0;2021-01-28;122006;14360;1509691;25228
FR;0;2021-01-29;90758;17293;1600449;42521
FR;0;2021-01-30;28621;4225;1629070;46746
FR;0;2021-01-31;4863;1679;1633933;48425
FR;0;2021-02-01;51407;21128;1685340;69553
FR;0;2021-02-02;70399;34568;1755739;104121
FR;0;2021-02-03;70834;36960;1826573;141081
FR;0;2021-02-04;80291;50060;1906864;191141
FR;0;2021-02-05;66858;45341;1973722;236482
FR;0;2021-02-06;21260;10399;1994982;246881
FR;0;2021-02-07;4826;5041;1999808;251922
FR;0;2021-02-08;45773;45993;2045581;297915
FR;0;2021-02-09;64639;72407;2110220;370322
FR;0;2021-02-10;69104;76695;2179324;447017
FR;0;2021-02-11;85335;99144;2264659;546161
FR;0;2021-02-12;77502;74276;2342161;620437
FR;0;2021-02-13;21598;19492;2363759;639929
FR;0;2021-02-14;4564;7190;2368323;647119
FR;0;2021-02-15;36878;76507;2405201;723626
FR;0;2021-02-16;49088;100746;2454289;824372
FR;0;2021-02-17;49200;102971;2503489;927343
FR;0;2021-02-18;67626;118562;2571115;1045905
FR;0;2021-02-19;63477;90735;2634592;1136640
FR;0;2021-02-20;17913;28428;2652505;1165068
FR;0;2021-02-21;2843;6373;2655348;1171441
FR;0;2021-02-22;36277;73137;2691625;1244578
FR;0;2021-02-23;52266;84058;2743891;1328636
FR;0;2021-02-24;57805;81129;2801696;1409765
FR;0;2021-02-25;97899;91420;2899595;1501185
FR;0;2021-02-26;111082;71011;3010677;1572196
FR;0;2021-02-27;50839;21980;3061516;1594176
FR;0;2021-02-28;5638;4414;3067154;1598590
FR;0;2021-03-01;63114;52804;3130268;1651394
FR;0;2021-03-02;98722;66246;3228990;1717640
FR;0;2021-03-03;112752;65551;3341742;1783191
FR;0;2021-03-04;158755;68881;3500497;1852072
FR;0;2021-03-05;196343;63393;3696840;1915465
FR;0;2021-03-06;202863;17824;3899703;1933289
FR;0;2021-03-07;118991;5481;4018694;1938770
FR;0;2021-03-08;104113;50808;4122807;1989578
FR;0;2021-03-09;168558;56778;4291365;2046356
FR;0;2021-03-10;174453;57215;4465818;2103571
FR;0;2021-03-11;237738;63118;4703556;2166689
FR;0;2021-03-12;289122;53506;4992678;2220195
FR;0;2021-03-13;226755;15284;5219433;2235479
FR;0;2021-03-14;61965;3437;5281398;2238916
FR;0;2021-03-15;154916;32673;5436314;2271589
FR;0;2021-03-16;139004;39541;5575318;2311130
FR;0;2021-03-17;147595;38826;5722913;2349956
FR;0;2021-03-18;164573;44664;5887486;2394620
FR;0;2021-03-19;225718;37486;6113204;2432106
FR;0;2021-03-20;164028;11787;6277232;2443893
FR;0;2021-03-21;48676;2628;6325908;2446521
FR;0;2021-03-22;166543;34300;6492451;2480821
FR;0;2021-03-23;245860;42406;6738311;2523227
FR;0;2021-03-24;252370;43869;6990681;2567096
FR;0;2021-03-25;336217;44754;7326898;2611850
FR;0;2021-03-26;353520;41911;7680418;2653761
FR;0;2021-03-27;192353;16653;7872771;2670414
FR;0;2021-03-28;58230;3737;7931001;2674151
FR;0;2021-03-29;199799;54310;8130800;2728461
FR;0;2021-03-30;281010;69686;8411810;2798147
FR;0;2021-03-31;258417;72951;8670227;2871098
FR;0;2021-04-01;308559;87852;8978786;2958950
FR;0;2021-04-02;276754;92127;9255540;3051077
FR;0;2021-04-03;138821;61876;9394361;3112953
FR;0;2021-04-04;44795;18665;9439156;3131618
FR;0;2021-04-05;58669;11009;9497825;3142627
FR;0;2021-04-06;212231;107897;9710056;3250524
FR;0;2021-04-07;255231;115503;9965287;3366027
FR;0;2021-04-08;331327;121458;10296614;3487485
FR;0;2021-04-09;402839;116530;10699453;3604015
FR;0;2021-04-10;209730;82763;10909183;3686778
FR;0;2021-04-11;54869;34603;10964052;3721381
FR;0;2021-04-12;232838;115247;11196890;3836628
FR;0;2021-04-13;303729;144998;11500619;3981626
FR;0;2021-04-14;287806;139445;11788425;4121071
FR;0;2021-04-15;329108;147886;12117533;4268957
FR;0;2021-04-16;332823;145795;12450356;4414752
FR;0;2021-04-17;185324;90278;12635680;4505030
FR;0;2021-04-18;50185;35432;12685865;4540462
FR;0;2021-04-19;201058;138428;12886923;4678890
FR;0;2021-04-20;248383;170790;13135306;4849680
FR;0;2021-04-21;245703;168873;13381009;5018553
FR;0;2021-04-22;280335;188302;13661344;5206855
FR;0;2021-04-23;287628;183307;13948972;5390162
FR;0;2021-04-24;186761;111605;14135733;5501767
FR;0;2021-04-25;67284;38887;14203017;5540654
FR;0;2021-04-26;213515;156140;14416532;5696794
FR;0;2021-04-27;278328;187562;14694860;5884356
FR;0;2021-04-28;292640;183253;14987500;6067609
FR;0;2021-04-29;347810;196193;15335310;6263802
FR;0;2021-04-30;363686;184897;15698996;6448699
FR;0;2021-05-01;159145;52554;15858141;6501253
FR;0;2021-05-02;89197;37847;15947338;6539100
FR;0;2021-05-03;279346;169755;16226684;6708855
FR;0;2021-05-04;305630;224394;16532314;6933249
FR;0;2021-05-05;314088;224597;16846402;7157846
FR;0;2021-05-06;367051;239281;17213453;7397127
FR;0;2021-05-07;360289;257422;17573742;7654549
FR;0;2021-05-08;200303;66946;17774045;7721495
FR;0;2021-05-09;127046;46785;17901091;7768280
FR;0;2021-05-10;297955;229086;18199046;7997366
FR;0;2021-05-11;389914;258282;18588960;8255648
FR;0;2021-05-12;410626;233331;18999586;8488979
FR;0;2021-05-13;325286;56935;19324872;8545914
FR;0;2021-05-14;435815;167644;19760687;8713558
FR;0;2021-05-15;359206;94070;20119893;8807628
FR;0;2021-05-16;197895;20844;20317788;8828472
