fra;vaccin;jour;n_dose1;n_dose2;n_cum_dose1;n_cum_dose2
FR;1;2020-12-27;20;0;20;0
FR;1;2020-12-28;62;0;82;0
FR;1;2020-12-29;108;0;190;0
FR;1;2020-12-30;116;0;306;0
FR;1;2020-12-31;83;0;389;0
FR;1;2021-01-01;65;0;454;0
FR;1;2021-01-02;75;0;529;0
FR;1;2021-01-03;87;0;616;0
FR;1;2021-01-04;1468;0;2084;0
FR;1;2021-01-05;5373;0;7457;0
FR;1;2021-01-06;11270;0;18727;0
FR;1;2021-01-07;28507;0;47234;0
FR;1;2021-01-08;35979;0;83213;0
FR;1;2021-01-09;10877;0;94090;0
FR;1;2021-01-10;5601;0;99691;0
FR;1;2021-01-11;38813;0;138504;0
FR;1;2021-01-12;60568;0;199072;0
FR;1;2021-01-13;63504;0;262576;0
FR;1;2021-01-14;79476;0;342052;0
FR;1;2021-01-15;66921;0;408973;0
FR;1;2021-01-16;19407;78;428380;78
FR;1;2021-01-17;10445;42;438825;120
FR;1;2021-01-18;81310;163;520135;283
FR;1;2021-01-19;123619;127;643754;410
FR;1;2021-01-20;129829;159;773583;569
FR;1;2021-01-21;149695;135;923278;704
FR;1;2021-01-22;113289;162;1036567;866
FR;1;2021-01-23;36016;50;1072583;916
FR;1;2021-01-24;9247;27;1081830;943
FR;1;2021-01-25;72992;1218;1154822;2161
FR;1;2021-01-26;94855;3110;1249677;5271
FR;1;2021-01-27;102035;5597;1351712;10868
FR;1;2021-01-28;118505;14360;1470217;25228
FR;1;2021-01-29;87619;17293;1557836;42521
FR;1;2021-01-30;27565;4225;1585401;46746
FR;1;2021-01-31;4862;1679;1590263;48425
FR;1;2021-02-01;48150;21128;1638413;69553
FR;1;2021-02-02;66083;34568;1704496;104121
FR;1;2021-02-03;65782;36960;1770278;141081
FR;1;2021-02-04;75510;50057;1845788;191138
FR;1;2021-02-05;62297;45335;1908085;236473
FR;1;2021-02-06;19030;10396;1927115;246869
FR;1;2021-02-07;3435;5041;1930550;251910
FR;1;2021-02-08;35724;45985;1966274;297895
FR;1;2021-02-09;49757;72392;2016031;370287
FR;1;2021-02-10;50787;76646;2066818;446933
FR;1;2021-02-11;61970;99077;2128788;546010
FR;1;2021-02-12;54721;74038;2183509;620048
FR;1;2021-02-13;15101;19270;2198610;639318
FR;1;2021-02-14;3408;7190;2202018;646508
FR;1;2021-02-15;23522;73440;2225540;719948
FR;1;2021-02-16;32039;96864;2257579;816812
FR;1;2021-02-17;34326;98568;2291905;915380
FR;1;2021-02-18;47898;113475;2339803;1028855
FR;1;2021-02-19;44333;86412;2384136;1115267
FR;1;2021-02-20;13006;26919;2397142;1142186
FR;1;2021-02-21;2109;6287;2399251;1148473
FR;1;2021-02-22;23975;69414;2423226;1217887
FR;1;2021-02-23;36501;80365;2459727;1298252
FR;1;2021-02-24;39290;77661;2499017;1375913
FR;1;2021-02-25;48707;87994;2547724;1463907
FR;1;2021-02-26;45944;67886;2593668;1531793
FR;1;2021-02-27;15164;20930;2608832;1552723
FR;1;2021-02-28;3226;4386;2612058;1557109
FR;1;2021-03-01;38621;49029;2650679;1606138
FR;1;2021-03-02;54531;61505;2705210;1667643
FR;1;2021-03-03;59303;60650;2764513;1728293
FR;1;2021-03-04;70852;64894;2835365;1793187
FR;1;2021-03-05;72982;59269;2908347;1852456
FR;1;2021-03-06;81249;16091;2989596;1868547
FR;1;2021-03-07;62942;5422;3052538;1873969
FR;1;2021-03-08;58635;42474;3111173;1916443
FR;1;2021-03-09;84194;48316;3195367;1964759
FR;1;2021-03-10;88763;48064;3284130;2012823
FR;1;2021-03-11;102950;53858;3387080;2066681
FR;1;2021-03-12;101961;45266;3489041;2111947
FR;1;2021-03-13;87467;12720;3576508;2124667
FR;1;2021-03-14;43617;3031;3620125;2127698
FR;1;2021-03-15;93573;29150;3713698;2156848
FR;1;2021-03-16;121702;34905;3835400;2191753
FR;1;2021-03-17;127137;34868;3962537;2226621
FR;1;2021-03-18;140532;39750;4103069;2266371
FR;1;2021-03-19;133979;32912;4237048;2299283
FR;1;2021-03-20;74861;10211;4311909;2309494
FR;1;2021-03-21;25759;2476;4337668;2311970
FR;1;2021-03-22;112762;31188;4450430;2343158
FR;1;2021-03-23;140577;38173;4591007;2381331
FR;1;2021-03-24;139595;38790;4730602;2420121
FR;1;2021-03-25;162368;39617;4892970;2459738
FR;1;2021-03-26;163839;37495;5056809;2497233
FR;1;2021-03-27;109726;15256;5166535;2512489
FR;1;2021-03-28;41699;3624;5208234;2516113
FR;1;2021-03-29;127963;49969;5336197;2566082
FR;1;2021-03-30;165011;63596;5501208;2629678
FR;1;2021-03-31;168086;66913;5669294;2696591
FR;1;2021-04-01;190120;79252;5859414;2775843
FR;1;2021-04-02;161748;84318;6021162;2860161
FR;1;2021-04-03;86937;58184;6108099;2918345
FR;1;2021-04-04;32262;17732;6140361;2936077
FR;1;2021-04-05;42346;10177;6182707;2946254
FR;1;2021-04-06;156655;100887;6339362;3047141
FR;1;2021-04-07;193212;108269;6532574;3155410
FR;1;2021-04-08;217357;112405;6749931;3267815
FR;1;2021-04-09;209788;107518;6959719;3375333
FR;1;2021-04-10;115925;73462;7075644;3448795
FR;1;2021-04-11;40038;30288;7115682;3479083
FR;1;2021-04-12;165569;103796;7281251;3582879
FR;1;2021-04-13;199548;128256;7480799;3711135
FR;1;2021-04-14;203190;122819;7683989;3833954
FR;1;2021-04-15;215194;126758;7899183;3960712
FR;1;2021-04-16;201002;125148;8100185;4085860
FR;1;2021-04-17;119733;67479;8219918;4153339
FR;1;2021-04-18;34884;20992;8254802;4174331
FR;1;2021-04-19;160006;121928;8414808;4296259
FR;1;2021-04-20;184594;148796;8599402;4445055
FR;1;2021-04-21;189203;146750;8788605;4591805
FR;1;2021-04-22;203532;162647;8992137;4754452
FR;1;2021-04-23;193755;156930;9185892;4911382
FR;1;2021-04-24;123745;95506;9309637;5006888
FR;1;2021-04-25;51853;30129;9361490;5037017
FR;1;2021-04-26;174872;138279;9536362;5175296
FR;1;2021-04-27;216406;162008;9752768;5337304
FR;1;2021-04-28;232042;155136;9984810;5492440
FR;1;2021-04-29;260818;160092;10245628;5652532
FR;1;2021-04-30;263210;148176;10508838;5800708
FR;1;2021-05-01;132795;40718;10641633;5841426
FR;1;2021-05-02;79249;28163;10720882;5869589
FR;1;2021-05-03;241576;146547;10962458;6016136
FR;1;2021-05-04;255865;186876;11218323;6203012
FR;1;2021-05-05;271729;184599;11490052;6387611
FR;1;2021-05-06;298120;183068;11788172;6570679
FR;1;2021-05-07;274319;195762;12062491;6766441
FR;1;2021-05-08;164338;48326;12226829;6814767
FR;1;2021-05-09;111944;36232;12338773;6850999
FR;1;2021-05-10;242662;194295;12581435;7045294
FR;1;2021-05-11;304448;211450;12885883;7256744
FR;2;2020-12-27;0;0;0;0
FR;2;2020-12-28;0;0;0;0
FR;2;2020-12-29;0;0;0;0
FR;2;2020-12-30;0;0;0;0
FR;2;2020-12-31;0;0;0;0
FR;2;2021-01-01;0;0;0;0
FR;2;2021-01-02;0;0;0;0
FR;2;2021-01-03;0;0;0;0
FR;2;2021-01-04;0;0;0;0
FR;2;2021-01-05;0;0;0;0
FR;2;2021-01-06;0;0;0;0
FR;2;2021-01-07;0;0;0;0
FR;2;2021-01-08;0;0;0;0
FR;2;2021-01-09;0;0;0;0
FR;2;2021-01-10;0;0;0;0
FR;2;2021-01-11;0;0;0;0
FR;2;2021-01-12;0;0;0;0
FR;2;2021-01-13;0;0;0;0
FR;2;2021-01-14;142;0;142;0
FR;2;2021-01-15;217;0;359;0
FR;2;2021-01-16;185;0;544;0
FR;2;2021-01-17;3;0;547;0
FR;2;2021-01-18;2902;0;3449;0
FR;2;2021-01-19;4484;0;7933;0
FR;2;2021-01-20;4903;0;12836;0
FR;2;2021-01-21;5065;0;17901;0
FR;2;2021-01-22;4858;0;22759;0
FR;2;2021-01-23;1727;0;24486;0
FR;2;2021-01-24;83;0;24569;0
FR;2;2021-01-25;3633;0;28202;0
FR;2;2021-01-26;3694;0;31896;0
FR;2;2021-01-27;3402;0;35298;0
FR;2;2021-01-28;3479;0;38777;0
FR;2;2021-01-29;3071;0;41848;0
FR;2;2021-01-30;1054;0;42902;0
FR;2;2021-01-31;0;0;42902;0
FR;2;2021-02-01;3247;0;46149;0
FR;2;2021-02-02;4302;0;50451;0
FR;2;2021-02-03;5029;0;55480;0
FR;2;2021-02-04;4670;3;60150;3
FR;2;2021-02-05;4549;6;64699;9
FR;2;2021-02-06;1929;3;66628;12
FR;2;2021-02-07;42;0;66670;12
FR;2;2021-02-08;7415;8;74085;20
FR;2;2021-02-09;8249;15;82334;35
FR;2;2021-02-10;9134;49;91468;84
FR;2;2021-02-11;10048;67;101516;151
FR;2;2021-02-12;9759;238;111275;389
FR;2;2021-02-13;3010;222;114285;611
FR;2;2021-02-14;296;0;114581;611
FR;2;2021-02-15;3355;3067;117936;3678
FR;2;2021-02-16;4901;3881;122837;7559
FR;2;2021-02-17;4098;4403;126935;11962
FR;2;2021-02-18;5228;5087;132163;17049
FR;2;2021-02-19;5095;4322;137258;21371
FR;2;2021-02-20;1763;1509;139021;22880
FR;2;2021-02-21;197;86;139218;22966
FR;2;2021-02-22;3510;3723;142728;26689
FR;2;2021-02-23;4801;3693;147529;30382
FR;2;2021-02-24;4738;3468;152267;33850
FR;2;2021-02-25;5289;3426;157556;37276
FR;2;2021-02-26;4193;3124;161749;40400
FR;2;2021-02-27;1500;1042;163249;41442
FR;2;2021-02-28;99;28;163348;41470
FR;2;2021-03-01;4944;3764;168292;45234
FR;2;2021-03-02;6294;4728;174586;49962
FR;2;2021-03-03;6238;4882;180824;54844
FR;2;2021-03-04;8065;3967;188889;58811
FR;2;2021-03-05;7754;4059;196643;62870
FR;2;2021-03-06;4619;1682;201262;64552
FR;2;2021-03-07;2283;29;203545;64581
FR;2;2021-03-08;3977;8309;207522;72890
FR;2;2021-03-09;7262;8429;214784;81319
FR;2;2021-03-10;6848;9108;221632;90427
FR;2;2021-03-11;9039;9208;230671;99635
FR;2;2021-03-12;7696;8169;238367;107804
FR;2;2021-03-13;9863;2510;248230;110314
FR;2;2021-03-14;4752;400;252982;110714
FR;2;2021-03-15;10624;3482;263606;114196
FR;2;2021-03-16;16431;4621;280037;118817
FR;2;2021-03-17;19882;3952;299919;122769
FR;2;2021-03-18;22936;4910;322855;127679
FR;2;2021-03-19;22866;4536;345721;132215
FR;2;2021-03-20;25135;1540;370856;133755
FR;2;2021-03-21;17466;147;388322;133902
FR;2;2021-03-22;17369;3078;405691;136980
FR;2;2021-03-23;22252;4183;427943;141163
FR;2;2021-03-24;23514;4987;451457;146150
FR;2;2021-03-25;26238;5020;477695;151170
FR;2;2021-03-26;26564;4260;504259;155430
FR;2;2021-03-27;15630;1309;519889;156739
FR;2;2021-03-28;10391;94;530280;156833
FR;2;2021-03-29;18613;4280;548893;161113
FR;2;2021-03-30;24138;6002;573031;167115
FR;2;2021-03-31;27964;5956;600995;173071
FR;2;2021-04-01;33752;8495;634747;181566
FR;2;2021-04-02;29346;7661;664093;189227
FR;2;2021-04-03;16712;3582;680805;192809
FR;2;2021-04-04;9152;918;689957;193727
FR;2;2021-04-05;12109;811;702066;194538
FR;2;2021-04-06;26639;6934;728705;201472
FR;2;2021-04-07;30405;7174;759110;208646
FR;2;2021-04-08;36410;8818;795520;217464
FR;2;2021-04-09;33312;8601;828832;226065
FR;2;2021-04-10;19417;8968;848249;235033
FR;2;2021-04-11;7808;4271;856057;239304
FR;2;2021-04-12;16744;11254;872801;250558
FR;2;2021-04-13;18990;16426;891791;266984
FR;2;2021-04-14;17526;16284;909317;283268
FR;2;2021-04-15;21728;20757;931045;304025
FR;2;2021-04-16;20220;20073;951265;324098
FR;2;2021-04-17;12950;22462;964215;346560
FR;2;2021-04-18;5764;14405;969979;360965
FR;2;2021-04-19;16370;16261;986349;377226
FR;2;2021-04-20;18861;21595;1005210;398821
FR;2;2021-04-21;18305;21665;1023515;420486
FR;2;2021-04-22;23155;24861;1046670;445347
FR;2;2021-04-23;23979;25346;1070649;470693
FR;2;2021-04-24;24951;15111;1095600;485804
FR;2;2021-04-25;9405;8589;1105005;494393
FR;2;2021-04-26;16575;17193;1121580;511586
FR;2;2021-04-27;18860;24305;1140440;535891
FR;2;2021-04-28;21289;26189;1161729;562080
FR;2;2021-04-29;24566;30136;1186295;592216
FR;2;2021-04-30;24897;27782;1211192;619998
FR;2;2021-05-01;14749;9863;1225941;629861
FR;2;2021-05-02;6472;9184;1232413;639045
FR;2;2021-05-03;18864;19327;1251277;658372
FR;2;2021-05-04;17797;29055;1269074;687427
FR;2;2021-05-05;17811;29416;1286885;716843
FR;2;2021-05-06;22957;35293;1309842;752136
FR;2;2021-05-07;23489;33243;1333331;785379
FR;2;2021-05-08;18824;9703;1352155;795082
FR;2;2021-05-09;12881;7894;1365036;802976
FR;2;2021-05-10;31894;22221;1396930;825197
FR;2;2021-05-11;41938;21079;1438868;846276
FR;3;2020-12-27;0;0;0;0
FR;3;2020-12-28;0;0;0;0
FR;3;2020-12-29;0;0;0;0
FR;3;2020-12-30;0;0;0;0
FR;3;2020-12-31;0;0;0;0
FR;3;2021-01-01;0;0;0;0
FR;3;2021-01-02;0;0;0;0
FR;3;2021-01-03;0;0;0;0
FR;3;2021-01-04;0;0;0;0
FR;3;2021-01-05;0;0;0;0
FR;3;2021-01-06;0;0;0;0
FR;3;2021-01-07;0;0;0;0
FR;3;2021-01-08;0;0;0;0
FR;3;2021-01-09;0;0;0;0
FR;3;2021-01-10;0;0;0;0
FR;3;2021-01-11;0;0;0;0
FR;3;2021-01-12;0;0;0;0
FR;3;2021-01-13;0;0;0;0
FR;3;2021-01-14;0;0;0;0
FR;3;2021-01-15;0;0;0;0
FR;3;2021-01-16;0;0;0;0
FR;3;2021-01-17;0;0;0;0
FR;3;2021-01-18;0;0;0;0
FR;3;2021-01-19;0;0;0;0
FR;3;2021-01-20;0;0;0;0
FR;3;2021-01-21;0;0;0;0
FR;3;2021-01-22;0;0;0;0
FR;3;2021-01-23;0;0;0;0
FR;3;2021-01-24;0;0;0;0
FR;3;2021-01-25;0;0;0;0
FR;3;2021-01-26;0;0;0;0
FR;3;2021-01-27;0;0;0;0
FR;3;2021-01-28;0;0;0;0
FR;3;2021-01-29;0;0;0;0
FR;3;2021-01-30;0;0;0;0
FR;3;2021-01-31;0;0;0;0
FR;3;2021-02-01;0;0;0;0
FR;3;2021-02-02;0;0;0;0
FR;3;2021-02-03;0;0;0;0
FR;3;2021-02-04;0;0;0;0
FR;3;2021-02-05;0;0;0;0
FR;3;2021-02-06;295;0;295;0
FR;3;2021-02-07;1348;0;1643;0
FR;3;2021-02-08;2627;0;4270;0
FR;3;2021-02-09;6618;0;10888;0
FR;3;2021-02-10;9171;0;20059;0
FR;3;2021-02-11;13264;0;33323;0
FR;3;2021-02-12;12958;0;46281;0
FR;3;2021-02-13;3477;0;49758;0
FR;3;2021-02-14;857;0;50615;0
FR;3;2021-02-15;9983;0;60598;0
FR;3;2021-02-16;12095;0;72693;0
FR;3;2021-02-17;10741;0;83434;0
FR;3;2021-02-18;14334;0;97768;0
FR;3;2021-02-19;13979;0;111747;0
FR;3;2021-02-20;3110;0;114857;0
FR;3;2021-02-21;534;0;115391;0
FR;3;2021-02-22;8778;0;124169;0
FR;3;2021-02-23;10929;0;135098;0
FR;3;2021-02-24;13748;0;148846;0
FR;3;2021-02-25;43849;0;192695;0
FR;3;2021-02-26;60860;0;253555;0
FR;3;2021-02-27;34101;8;287656;8
FR;3;2021-02-28;2310;0;289966;8
FR;3;2021-03-01;19481;11;309447;19
FR;3;2021-03-02;37839;13;347286;32
FR;3;2021-03-03;47097;19;394383;51
FR;3;2021-03-04;79705;20;474088;71
FR;3;2021-03-05;115457;65;589545;136
FR;3;2021-03-06;116813;51;706358;187
FR;3;2021-03-07;53720;30;760078;217
FR;3;2021-03-08;41454;25;801532;242
FR;3;2021-03-09;76976;33;878508;275
FR;3;2021-03-10;78728;43;957236;318
FR;3;2021-03-11;125583;52;1082819;370
FR;3;2021-03-12;179300;71;1262119;441
FR;3;2021-03-13;129178;54;1391297;495
FR;3;2021-03-14;13579;6;1404876;501
FR;3;2021-03-15;50684;41;1455560;542
FR;3;2021-03-16;842;15;1456402;557
FR;3;2021-03-17;560;6;1456962;563
FR;3;2021-03-18;1084;4;1458046;567
FR;3;2021-03-19;68811;38;1526857;605
FR;3;2021-03-20;63987;36;1590844;641
FR;3;2021-03-21;5445;5;1596289;646
FR;3;2021-03-22;36384;34;1632673;680
FR;3;2021-03-23;83002;50;1715675;730
FR;3;2021-03-24;89246;92;1804921;822
FR;3;2021-03-25;147557;117;1952478;939
FR;3;2021-03-26;163028;156;2115506;1095
FR;3;2021-03-27;66950;88;2182456;1183
FR;3;2021-03-28;6137;19;2188593;1202
FR;3;2021-03-29;53156;61;2241749;1263
FR;3;2021-03-30;91749;88;2333498;1351
FR;3;2021-03-31;62162;82;2395660;1433
FR;3;2021-04-01;84427;105;2480087;1538
FR;3;2021-04-02;85541;148;2565628;1686
FR;3;2021-04-03;35126;110;2600754;1796
FR;3;2021-04-04;3371;15;2604125;1811
FR;3;2021-04-05;4198;21;2608323;1832
FR;3;2021-04-06;28818;76;2637141;1908
FR;3;2021-04-07;31452;60;2668593;1968
FR;3;2021-04-08;77336;235;2745929;2203
FR;3;2021-04-09;159523;411;2905452;2614
FR;3;2021-04-10;74286;333;2979738;2947
FR;3;2021-04-11;6999;44;2986737;2991
FR;3;2021-04-12;50406;197;3037143;3188
FR;3;2021-04-13;84906;316;3122049;3504
FR;3;2021-04-14;66392;342;3188441;3846
FR;3;2021-04-15;91489;371;3279930;4217
FR;3;2021-04-16;110800;574;3390730;4791
FR;3;2021-04-17;52102;337;3442832;5128
FR;3;2021-04-18;9417;35;3452249;5163
FR;3;2021-04-19;24370;239;3476619;5402
FR;3;2021-04-20;44689;399;3521308;5801
FR;3;2021-04-21;37950;458;3559258;6259
FR;3;2021-04-22;53478;794;3612736;7053
FR;3;2021-04-23;69192;1031;3681928;8084
FR;3;2021-04-24;36427;988;3718355;9072
FR;3;2021-04-25;5892;169;3724247;9241
FR;3;2021-04-26;19051;668;3743298;9909
FR;3;2021-04-27;33603;1246;3776901;11155
FR;3;2021-04-28;28158;1925;3805059;13080
FR;3;2021-04-29;44396;5958;3849455;19038
FR;3;2021-04-30;54357;8932;3903812;27970
FR;3;2021-05-01;9092;1968;3912904;29938
FR;3;2021-05-02;2795;500;3915699;30438
FR;3;2021-05-03;12431;3880;3928130;34318
FR;3;2021-05-04;22271;8455;3950401;42773
FR;3;2021-05-05;17885;10575;3968286;53348
FR;3;2021-05-06;33695;20907;4001981;74255
FR;3;2021-05-07;42908;28407;4044889;102662
FR;3;2021-05-08;6059;8913;4050948;111575
FR;3;2021-05-09;1540;2657;4052488;114232
FR;3;2021-05-10;14120;12559;4066608;126791
FR;3;2021-05-11;25831;25740;4092439;152531
FR;4;2020-12-27;0;0;0;0
FR;4;2020-12-28;0;0;0;0
FR;4;2020-12-29;0;0;0;0
FR;4;2020-12-30;0;0;0;0
FR;4;2020-12-31;0;0;0;0
FR;4;2021-01-01;0;0;0;0
FR;4;2021-01-02;0;0;0;0
FR;4;2021-01-03;0;0;0;0
FR;4;2021-01-04;0;0;0;0
FR;4;2021-01-05;0;0;0;0
FR;4;2021-01-06;0;0;0;0
FR;4;2021-01-07;0;0;0;0
FR;4;2021-01-08;0;0;0;0
FR;4;2021-01-09;0;0;0;0
FR;4;2021-01-10;0;0;0;0
FR;4;2021-01-11;0;0;0;0
FR;4;2021-01-12;0;0;0;0
FR;4;2021-01-13;0;0;0;0
FR;4;2021-01-14;0;0;0;0
FR;4;2021-01-15;0;0;0;0
FR;4;2021-01-16;0;0;0;0
FR;4;2021-01-17;0;0;0;0
FR;4;2021-01-18;0;0;0;0
FR;4;2021-01-19;0;0;0;0
FR;4;2021-01-20;0;0;0;0
FR;4;2021-01-21;0;0;0;0
FR;4;2021-01-22;0;0;0;0
FR;4;2021-01-23;0;0;0;0
FR;4;2021-01-24;0;0;0;0
FR;4;2021-01-25;0;0;0;0
FR;4;2021-01-26;0;0;0;0
FR;4;2021-01-27;0;0;0;0
FR;4;2021-01-28;0;0;0;0
FR;4;2021-01-29;0;0;0;0
FR;4;2021-01-30;0;0;0;0
FR;4;2021-01-31;0;0;0;0
FR;4;2021-02-01;0;0;0;0
FR;4;2021-02-02;0;0;0;0
FR;4;2021-02-03;0;0;0;0
FR;4;2021-02-04;0;0;0;0
FR;4;2021-02-05;0;0;0;0
FR;4;2021-02-06;0;0;0;0
FR;4;2021-02-07;0;0;0;0
FR;4;2021-02-08;0;0;0;0
FR;4;2021-02-09;0;0;0;0
FR;4;2021-02-10;0;0;0;0
FR;4;2021-02-11;0;0;0;0
FR;4;2021-02-12;0;0;0;0
FR;4;2021-02-13;0;0;0;0
FR;4;2021-02-14;0;0;0;0
FR;4;2021-02-15;0;0;0;0
FR;4;2021-02-16;0;0;0;0
FR;4;2021-02-17;0;0;0;0
FR;4;2021-02-18;0;0;0;0
FR;4;2021-02-19;0;0;0;0
FR;4;2021-02-20;0;0;0;0
FR;4;2021-02-21;0;0;0;0
FR;4;2021-02-22;0;0;0;0
FR;4;2021-02-23;0;0;0;0
FR;4;2021-02-24;0;0;0;0
FR;4;2021-02-25;0;0;0;0
FR;4;2021-02-26;0;0;0;0
FR;4;2021-02-27;0;0;0;0
FR;4;2021-02-28;0;0;0;0
FR;4;2021-03-01;0;0;0;0
FR;4;2021-03-02;0;0;0;0
FR;4;2021-03-03;0;0;0;0
FR;4;2021-03-04;0;0;0;0
FR;4;2021-03-05;0;0;0;0
FR;4;2021-03-06;0;0;0;0
FR;4;2021-03-07;0;0;0;0
FR;4;2021-03-08;0;0;0;0
FR;4;2021-03-09;0;0;0;0
FR;4;2021-03-10;0;0;0;0
FR;4;2021-03-11;0;0;0;0
FR;4;2021-03-12;0;0;0;0
FR;4;2021-03-13;0;0;0;0
FR;4;2021-03-14;0;0;0;0
FR;4;2021-03-15;0;0;0;0
FR;4;2021-03-16;0;0;0;0
FR;4;2021-03-17;0;0;0;0
FR;4;2021-03-18;0;0;0;0
FR;4;2021-03-19;0;0;0;0
FR;4;2021-03-20;0;0;0;0
FR;4;2021-03-21;0;0;0;0
FR;4;2021-03-22;0;0;0;0
FR;4;2021-03-23;0;0;0;0
FR;4;2021-03-24;0;0;0;0
FR;4;2021-03-25;0;0;0;0
FR;4;2021-03-26;0;0;0;0
FR;4;2021-03-27;0;0;0;0
FR;4;2021-03-28;0;0;0;0
FR;4;2021-03-29;0;0;0;0
FR;4;2021-03-30;0;0;0;0
FR;4;2021-03-31;0;0;0;0
FR;4;2021-04-01;0;0;0;0
FR;4;2021-04-02;0;0;0;0
FR;4;2021-04-03;0;0;0;0
FR;4;2021-04-04;0;0;0;0
FR;4;2021-04-05;0;0;0;0
FR;4;2021-04-06;0;0;0;0
FR;4;2021-04-07;0;0;0;0
FR;4;2021-04-08;0;0;0;0
FR;4;2021-04-09;0;0;0;0
FR;4;2021-04-10;0;0;0;0
FR;4;2021-04-11;0;0;0;0
FR;4;2021-04-12;0;0;0;0
FR;4;2021-04-13;0;0;0;0
FR;4;2021-04-14;0;0;0;0
FR;4;2021-04-15;0;0;0;0
FR;4;2021-04-16;0;0;0;0
FR;4;2021-04-17;0;0;0;0
FR;4;2021-04-18;0;0;0;0
FR;4;2021-04-19;0;0;0;0
FR;4;2021-04-20;0;0;0;0
FR;4;2021-04-21;0;0;0;0
FR;4;2021-04-22;0;0;0;0
FR;4;2021-04-23;484;0;484;0
FR;4;2021-04-24;1554;0;2038;0
FR;4;2021-04-25;117;0;2155;0
FR;4;2021-04-26;2818;0;4973;0
FR;4;2021-04-27;9345;3;14318;3
FR;4;2021-04-28;9737;3;24055;6
FR;4;2021-04-29;15826;7;39881;13
FR;4;2021-04-30;18995;7;58876;20
FR;4;2021-05-01;1873;5;60749;25
FR;4;2021-05-02;428;0;61177;25
FR;4;2021-05-03;4892;1;66069;26
FR;4;2021-05-04;8221;8;74290;34
FR;4;2021-05-05;5952;7;80242;41
FR;4;2021-05-06;11151;13;91393;54
FR;4;2021-05-07;18753;10;110146;64
FR;4;2021-05-08;2195;4;112341;68
FR;4;2021-05-09;612;2;112953;70
FR;4;2021-05-10;6988;9;119941;79
FR;4;2021-05-11;13759;12;133700;91
FR;0;2020-12-27;20;0;20;0
FR;0;2020-12-28;62;0;82;0
FR;0;2020-12-29;108;0;190;0
FR;0;2020-12-30;116;0;306;0
FR;0;2020-12-31;83;0;389;0
FR;0;2021-01-01;65;0;454;0
FR;0;2021-01-02;75;0;529;0
FR;0;2021-01-03;87;0;616;0
FR;0;2021-01-04;1468;0;2084;0
FR;0;2021-01-05;5373;0;7457;0
FR;0;2021-01-06;11270;0;18727;0
FR;0;2021-01-07;28507;0;47234;0
FR;0;2021-01-08;35979;0;83213;0
FR;0;2021-01-09;10877;0;94090;0
FR;0;2021-01-10;5601;0;99691;0
FR;0;2021-01-11;38813;0;138504;0
FR;0;2021-01-12;60568;0;199072;0
FR;0;2021-01-13;63504;0;262576;0
FR;0;2021-01-14;79618;0;342194;0
FR;0;2021-01-15;67138;0;409332;0
FR;0;2021-01-16;19592;78;428924;78
FR;0;2021-01-17;10448;42;439372;120
FR;0;2021-01-18;84212;163;523584;283
FR;0;2021-01-19;128103;127;651687;410
FR;0;2021-01-20;134732;159;786419;569
FR;0;2021-01-21;154760;135;941179;704
FR;0;2021-01-22;118147;162;1059326;866
FR;0;2021-01-23;37743;50;1097069;916
FR;0;2021-01-24;9330;27;1106399;943
FR;0;2021-01-25;76625;1218;1183024;2161
FR;0;2021-01-26;98549;3110;1281573;5271
FR;0;2021-01-27;105437;5597;1387010;10868
FR;0;2021-01-28;121984;14360;1508994;25228
FR;0;2021-01-29;90690;17293;1599684;42521
FR;0;2021-01-30;28619;4225;1628303;46746
FR;0;2021-01-31;4862;1679;1633165;48425
FR;0;2021-02-01;51397;21128;1684562;69553
FR;0;2021-02-02;70385;34568;1754947;104121
FR;0;2021-02-03;70811;36960;1825758;141081
FR;0;2021-02-04;80180;50060;1905938;191141
FR;0;2021-02-05;66846;45341;1972784;236482
FR;0;2021-02-06;21254;10399;1994038;246881
FR;0;2021-02-07;4825;5041;1998863;251922
FR;0;2021-02-08;45766;45993;2044629;297915
FR;0;2021-02-09;64624;72407;2109253;370322
FR;0;2021-02-10;69092;76695;2178345;447017
FR;0;2021-02-11;85282;99144;2263627;546161
FR;0;2021-02-12;77438;74276;2341065;620437
FR;0;2021-02-13;21588;19492;2362653;639929
FR;0;2021-02-14;4561;7190;2367214;647119
FR;0;2021-02-15;36860;76507;2404074;723626
FR;0;2021-02-16;49035;100745;2453109;824371
FR;0;2021-02-17;49165;102971;2502274;927342
FR;0;2021-02-18;67460;118562;2569734;1045904
FR;0;2021-02-19;63407;90734;2633141;1136638
FR;0;2021-02-20;17879;28428;2651020;1165066
FR;0;2021-02-21;2840;6373;2653860;1171439
FR;0;2021-02-22;36263;73137;2690123;1244576
FR;0;2021-02-23;52231;84058;2742354;1328634
FR;0;2021-02-24;57776;81129;2800130;1409763
FR;0;2021-02-25;97845;91420;2897975;1501183
FR;0;2021-02-26;110997;71010;3008972;1572193
FR;0;2021-02-27;50765;21980;3059737;1594173
FR;0;2021-02-28;5635;4414;3065372;1598587
FR;0;2021-03-01;63046;52804;3128418;1651391
FR;0;2021-03-02;98664;66246;3227082;1717637
FR;0;2021-03-03;112638;65551;3339720;1783188
FR;0;2021-03-04;158622;68881;3498342;1852069
FR;0;2021-03-05;196193;63393;3694535;1915462
FR;0;2021-03-06;202681;17824;3897216;1933286
FR;0;2021-03-07;118945;5481;4016161;1938767
FR;0;2021-03-08;104066;50808;4120227;1989575
FR;0;2021-03-09;168432;56778;4288659;2046353
FR;0;2021-03-10;174339;57215;4462998;2103568
FR;0;2021-03-11;237572;63118;4700570;2166686
FR;0;2021-03-12;288957;53506;4989527;2220192
FR;0;2021-03-13;226508;15284;5216035;2235476
FR;0;2021-03-14;61948;3437;5277983;2238913
FR;0;2021-03-15;154881;32673;5432864;2271586
FR;0;2021-03-16;138975;39541;5571839;2311127
FR;0;2021-03-17;147579;38826;5719418;2349953
FR;0;2021-03-18;164552;44664;5883970;2394617
FR;0;2021-03-19;225656;37486;6109626;2432103
FR;0;2021-03-20;163983;11787;6273609;2443890
FR;0;2021-03-21;48670;2628;6322279;2446518
FR;0;2021-03-22;166515;34300;6488794;2480818
FR;0;2021-03-23;245831;42406;6734625;2523224
FR;0;2021-03-24;252355;43869;6986980;2567093
FR;0;2021-03-25;336163;44754;7323143;2611847
FR;0;2021-03-26;353431;41911;7676574;2653758
FR;0;2021-03-27;192306;16653;7868880;2670411
FR;0;2021-03-28;58227;3737;7927107;2674148
FR;0;2021-03-29;199732;54310;8126839;2728458
FR;0;2021-03-30;280898;69686;8407737;2798144
FR;0;2021-03-31;258212;72951;8665949;2871095
FR;0;2021-04-01;308299;87852;8974248;2958947
FR;0;2021-04-02;276635;92127;9250883;3051074
FR;0;2021-04-03;138775;61876;9389658;3112950
FR;0;2021-04-04;44785;18665;9434443;3131615
FR;0;2021-04-05;58653;11009;9493096;3142624
FR;0;2021-04-06;212112;107897;9705208;3250521
FR;0;2021-04-07;255069;115503;9960277;3366024
FR;0;2021-04-08;331103;121458;10291380;3487482
FR;0;2021-04-09;402623;116530;10694003;3604012
FR;0;2021-04-10;209628;82763;10903631;3686775
FR;0;2021-04-11;54845;34603;10958476;3721378
FR;0;2021-04-12;232719;115247;11191195;3836625
FR;0;2021-04-13;303444;144998;11494639;3981623
FR;0;2021-04-14;287108;139445;11781747;4121068
FR;0;2021-04-15;328411;147886;12110158;4268954
FR;0;2021-04-16;332022;145795;12442180;4414749
FR;0;2021-04-17;184785;90278;12626965;4505027
FR;0;2021-04-18;50065;35432;12677030;4540459
FR;0;2021-04-19;200746;138428;12877776;4678887
FR;0;2021-04-20;248144;170790;13125920;4849677
FR;0;2021-04-21;245458;168873;13371378;5018550
FR;0;2021-04-22;280165;188302;13651543;5206852
FR;0;2021-04-23;287410;183307;13938953;5390159
FR;0;2021-04-24;186677;111605;14125630;5501764
FR;0;2021-04-25;67267;38887;14192897;5540651
FR;0;2021-04-26;213316;156140;14406213;5696791
FR;0;2021-04-27;278214;187562;14684427;5884353
FR;0;2021-04-28;291226;183253;14975653;6067606
FR;0;2021-04-29;345606;196193;15321259;6263799
FR;0;2021-04-30;361459;184897;15682718;6448696
FR;0;2021-05-01;158509;52554;15841227;6501250
FR;0;2021-05-02;88944;37847;15930171;6539097
FR;0;2021-05-03;277763;169755;16207934;6708852
FR;0;2021-05-04;304154;224394;16512088;6933246
FR;0;2021-05-05;313377;224597;16825465;7157843
FR;0;2021-05-06;365923;239281;17191388;7397124
FR;0;2021-05-07;359469;257422;17550857;7654546
FR;0;2021-05-08;191416;66946;17742273;7721492
FR;0;2021-05-09;126977;46785;17869250;7768277
FR;0;2021-05-10;295664;229084;18164914;7997361
FR;0;2021-05-11;385976;258281;18550890;8255642
