fra;vaccin;jour;n_dose1;n_dose2;n_cum_dose1;n_cum_dose2
FR;1;2020-12-27;20;0;20;0
FR;1;2020-12-28;63;0;83;0
FR;1;2020-12-29;108;0;191;0
FR;1;2020-12-30;119;0;310;0
FR;1;2020-12-31;83;0;393;0
FR;1;2021-01-01;65;0;458;0
FR;1;2021-01-02;76;0;534;0
FR;1;2021-01-03;87;0;621;0
FR;1;2021-01-04;1468;0;2089;0
FR;1;2021-01-05;5378;0;7467;0
FR;1;2021-01-06;11278;0;18745;0
FR;1;2021-01-07;28526;0;47271;0
FR;1;2021-01-08;36034;0;83305;0
FR;1;2021-01-09;10884;0;94189;0
FR;1;2021-01-10;5602;0;99791;0
FR;1;2021-01-11;38841;0;138632;0
FR;1;2021-01-12;60606;0;199238;0
FR;1;2021-01-13;63546;0;262784;0
FR;1;2021-01-14;79491;0;342275;0
FR;1;2021-01-15;66962;0;409237;0
FR;1;2021-01-16;19409;78;428646;78
FR;1;2021-01-17;10449;42;439095;120
FR;1;2021-01-18;81346;163;520441;283
FR;1;2021-01-19;123692;127;644133;410
FR;1;2021-01-20;129876;159;774009;569
FR;1;2021-01-21;149763;135;923772;704
FR;1;2021-01-22;113331;162;1037103;866
FR;1;2021-01-23;36017;50;1073120;916
FR;1;2021-01-24;9249;27;1082369;943
FR;1;2021-01-25;73016;1218;1155385;2161
FR;1;2021-01-26;94894;3110;1250279;5271
FR;1;2021-01-27;102044;5597;1352323;10868
FR;1;2021-01-28;118525;14360;1470848;25228
FR;1;2021-01-29;87686;17293;1558534;42521
FR;1;2021-01-30;27566;4225;1586100;46746
FR;1;2021-01-31;4862;1679;1590962;48425
FR;1;2021-02-01;48159;21128;1639121;69553
FR;1;2021-02-02;66096;34568;1705217;104121
FR;1;2021-02-03;65804;36960;1771021;141081
FR;1;2021-02-04;75517;50057;1846538;191138
FR;1;2021-02-05;62302;45335;1908840;236473
FR;1;2021-02-06;19031;10396;1927871;246869
FR;1;2021-02-07;3436;5041;1931307;251910
FR;1;2021-02-08;35731;45985;1967038;297895
FR;1;2021-02-09;49769;72392;2016807;370287
FR;1;2021-02-10;50786;76646;2067593;446933
FR;1;2021-02-11;62008;99077;2129601;546010
FR;1;2021-02-12;54736;74038;2184337;620048
FR;1;2021-02-13;15105;19270;2199442;639318
FR;1;2021-02-14;3409;7190;2202851;646508
FR;1;2021-02-15;23524;73440;2226375;719948
FR;1;2021-02-16;32073;96865;2258448;816813
FR;1;2021-02-17;34336;98568;2292784;915381
FR;1;2021-02-18;47950;113475;2340734;1028856
FR;1;2021-02-19;44344;86412;2385078;1115268
FR;1;2021-02-20;13007;26919;2398085;1142187
FR;1;2021-02-21;2109;6287;2400194;1148474
FR;1;2021-02-22;23981;69414;2424175;1217888
FR;1;2021-02-23;36508;80365;2460683;1298253
FR;1;2021-02-24;39304;77661;2499987;1375914
FR;1;2021-02-25;48715;87994;2548702;1463908
FR;1;2021-02-26;45963;67886;2594665;1531794
FR;1;2021-02-27;15166;20930;2609831;1552724
FR;1;2021-02-28;3226;4386;2613057;1557110
FR;1;2021-03-01;38662;49029;2651719;1606139
FR;1;2021-03-02;54557;61505;2706276;1667644
FR;1;2021-03-03;59305;60650;2765581;1728294
FR;1;2021-03-04;70865;64894;2836446;1793188
FR;1;2021-03-05;72992;59269;2909438;1852457
FR;1;2021-03-06;81255;16091;2990693;1868548
FR;1;2021-03-07;62945;5422;3053638;1873970
FR;1;2021-03-08;58641;42474;3112279;1916444
FR;1;2021-03-09;84229;48316;3196508;1964760
FR;1;2021-03-10;88777;48064;3285285;2012824
FR;1;2021-03-11;102993;53858;3388278;2066682
FR;1;2021-03-12;101975;45266;3490253;2111948
FR;1;2021-03-13;87474;12720;3577727;2124668
FR;1;2021-03-14;43619;3031;3621346;2127699
FR;1;2021-03-15;93581;29150;3714927;2156849
FR;1;2021-03-16;121712;34905;3836639;2191754
FR;1;2021-03-17;127149;34868;3963788;2226622
FR;1;2021-03-18;140546;39750;4104334;2266372
FR;1;2021-03-19;133999;32912;4238333;2299284
FR;1;2021-03-20;74867;10211;4313200;2309495
FR;1;2021-03-21;25763;2476;4338963;2311971
FR;1;2021-03-22;112779;31188;4451742;2343159
FR;1;2021-03-23;140588;38173;4592330;2381332
FR;1;2021-03-24;139613;38790;4731943;2420122
FR;1;2021-03-25;162391;39617;4894334;2459739
FR;1;2021-03-26;163881;37495;5058215;2497234
FR;1;2021-03-27;109730;15256;5167945;2512490
FR;1;2021-03-28;41700;3624;5209645;2516114
FR;1;2021-03-29;128017;49969;5337662;2566083
FR;1;2021-03-30;165085;63596;5502747;2629679
FR;1;2021-03-31;168172;66913;5670919;2696592
FR;1;2021-04-01;190312;79252;5861231;2775844
FR;1;2021-04-02;161825;84318;6023056;2860162
FR;1;2021-04-03;86964;58184;6110020;2918346
FR;1;2021-04-04;32271;17732;6142291;2936078
FR;1;2021-04-05;42356;10177;6184647;2946255
FR;1;2021-04-06;156757;100887;6341404;3047142
FR;1;2021-04-07;193327;108269;6534731;3155411
FR;1;2021-04-08;217502;112406;6752233;3267817
FR;1;2021-04-09;209932;107518;6962165;3375335
FR;1;2021-04-10;115949;73462;7078114;3448797
FR;1;2021-04-11;40059;30288;7118173;3479085
FR;1;2021-04-12;165659;103796;7283832;3582881
FR;1;2021-04-13;199780;128256;7483612;3711137
FR;1;2021-04-14;203806;122819;7687418;3833956
FR;1;2021-04-15;215807;126758;7903225;3960714
FR;1;2021-04-16;201635;125148;8104860;4085862
FR;1;2021-04-17;119958;67479;8224818;4153341
FR;1;2021-04-18;34935;20992;8259753;4174333
FR;1;2021-04-19;160290;121928;8420043;4296261
FR;1;2021-04-20;184639;148796;8604682;4445057
FR;1;2021-04-21;189305;146750;8793987;4591807
FR;1;2021-04-22;203652;162647;8997639;4754454
FR;1;2021-04-23;193838;156930;9191477;4911384
FR;1;2021-04-24;123781;95506;9315258;5006890
FR;1;2021-04-25;51857;30129;9367115;5037019
FR;1;2021-04-26;174988;138279;9542103;5175298
FR;1;2021-04-27;216449;162008;9758552;5337306
FR;1;2021-04-28;233251;155136;9991803;5492442
FR;1;2021-04-29;262816;160092;10254619;5652534
FR;1;2021-04-30;265225;148176;10519844;5800710
FR;1;2021-05-01;133345;40718;10653189;5841428
FR;1;2021-05-02;79490;28163;10732679;5869591
FR;1;2021-05-03;242973;146547;10975652;6016138
FR;1;2021-05-04;257178;186877;11232830;6203015
FR;1;2021-05-05;272314;184598;11505144;6387613
FR;1;2021-05-06;298998;183068;11804142;6570681
FR;1;2021-05-07;274798;195762;12078940;6766443
FR;1;2021-05-08;171232;48328;12250172;6814771
FR;1;2021-05-09;111977;36232;12362149;6851003
FR;1;2021-05-10;244517;194293;12606666;7045296
FR;1;2021-05-11;307338;211452;12914004;7256748
FR;1;2021-05-12;337039;185959;13251043;7442707
FR;1;2021-05-13;271404;47683;13522447;7490390
FR;1;2021-05-14;353891;128937;13876338;7619327
FR;2;2020-12-27;0;0;0;0
FR;2;2020-12-28;0;0;0;0
FR;2;2020-12-29;0;0;0;0
FR;2;2020-12-30;0;0;0;0
FR;2;2020-12-31;0;0;0;0
FR;2;2021-01-01;0;0;0;0
FR;2;2021-01-02;0;0;0;0
FR;2;2021-01-03;0;0;0;0
FR;2;2021-01-04;0;0;0;0
FR;2;2021-01-05;0;0;0;0
FR;2;2021-01-06;0;0;0;0
FR;2;2021-01-07;0;0;0;0
FR;2;2021-01-08;0;0;0;0
FR;2;2021-01-09;0;0;0;0
FR;2;2021-01-10;0;0;0;0
FR;2;2021-01-11;0;0;0;0
FR;2;2021-01-12;0;0;0;0
FR;2;2021-01-13;0;0;0;0
FR;2;2021-01-14;143;0;143;0
FR;2;2021-01-15;217;0;360;0
FR;2;2021-01-16;185;0;545;0
FR;2;2021-01-17;3;0;548;0
FR;2;2021-01-18;2902;0;3450;0
FR;2;2021-01-19;4485;0;7935;0
FR;2;2021-01-20;4903;0;12838;0
FR;2;2021-01-21;5065;0;17903;0
FR;2;2021-01-22;4858;0;22761;0
FR;2;2021-01-23;1728;0;24489;0
FR;2;2021-01-24;83;0;24572;0
FR;2;2021-01-25;3633;0;28205;0
FR;2;2021-01-26;3695;0;31900;0
FR;2;2021-01-27;3402;0;35302;0
FR;2;2021-01-28;3479;0;38781;0
FR;2;2021-01-29;3072;0;41853;0
FR;2;2021-01-30;1054;0;42907;0
FR;2;2021-01-31;0;0;42907;0
FR;2;2021-02-01;3247;0;46154;0
FR;2;2021-02-02;4302;0;50456;0
FR;2;2021-02-03;5029;0;55485;0
FR;2;2021-02-04;4724;3;60209;3
FR;2;2021-02-05;4549;6;64758;9
FR;2;2021-02-06;1929;3;66687;12
FR;2;2021-02-07;42;0;66729;12
FR;2;2021-02-08;7415;8;74144;20
FR;2;2021-02-09;8250;15;82394;35
FR;2;2021-02-10;9134;49;91528;84
FR;2;2021-02-11;10048;67;101576;151
FR;2;2021-02-12;9779;238;111355;389
FR;2;2021-02-13;3010;222;114365;611
FR;2;2021-02-14;296;0;114661;611
FR;2;2021-02-15;3356;3067;118017;3678
FR;2;2021-02-16;4901;3881;122918;7559
FR;2;2021-02-17;4098;4403;127016;11962
FR;2;2021-02-18;5228;5087;132244;17049
FR;2;2021-02-19;5116;4323;137360;21372
FR;2;2021-02-20;1763;1509;139123;22881
FR;2;2021-02-21;197;86;139320;22967
FR;2;2021-02-22;3511;3723;142831;26690
FR;2;2021-02-23;4801;3693;147632;30383
FR;2;2021-02-24;4738;3468;152370;33851
FR;2;2021-02-25;5289;3426;157659;37277
FR;2;2021-02-26;4193;3125;161852;40402
FR;2;2021-02-27;1500;1042;163352;41444
FR;2;2021-02-28;99;28;163451;41472
FR;2;2021-03-01;4954;3764;168405;45236
FR;2;2021-03-02;6300;4728;174705;49964
FR;2;2021-03-03;6238;4882;180943;54846
FR;2;2021-03-04;8065;3967;189008;58813
FR;2;2021-03-05;7765;4059;196773;62872
FR;2;2021-03-06;4619;1682;201392;64554
FR;2;2021-03-07;2283;29;203675;64583
FR;2;2021-03-08;3977;8309;207652;72892
FR;2;2021-03-09;7263;8429;214915;81321
FR;2;2021-03-10;6848;9108;221763;90429
FR;2;2021-03-11;9039;9208;230802;99637
FR;2;2021-03-12;7699;8169;238501;107806
FR;2;2021-03-13;9863;2510;248364;110316
FR;2;2021-03-14;4752;400;253116;110716
FR;2;2021-03-15;10626;3482;263742;114198
FR;2;2021-03-16;16430;4621;280172;118819
FR;2;2021-03-17;19882;3952;300054;122771
FR;2;2021-03-18;22937;4910;322991;127681
FR;2;2021-03-19;22868;4536;345859;132217
FR;2;2021-03-20;25137;1540;370996;133757
FR;2;2021-03-21;17467;147;388463;133904
FR;2;2021-03-22;17371;3078;405834;136982
FR;2;2021-03-23;22252;4183;428086;141165
FR;2;2021-03-24;23514;4988;451600;146153
FR;2;2021-03-25;26241;5020;477841;151173
FR;2;2021-03-26;26564;4260;504405;155433
FR;2;2021-03-27;15631;1309;520036;156742
FR;2;2021-03-28;10391;94;530427;156836
FR;2;2021-03-29;18617;4280;549044;161116
FR;2;2021-03-30;24144;6002;573188;167118
FR;2;2021-03-31;28033;5956;601221;173074
FR;2;2021-04-01;33797;8495;635018;181569
FR;2;2021-04-02;29372;7661;664390;189230
FR;2;2021-04-03;16716;3582;681106;192812
FR;2;2021-04-04;9152;918;690258;193730
FR;2;2021-04-05;12113;811;702371;194541
FR;2;2021-04-06;26641;6934;729012;201475
FR;2;2021-04-07;30417;7174;759429;208649
FR;2;2021-04-08;36447;8817;795876;217466
FR;2;2021-04-09;33317;8601;829193;226067
FR;2;2021-04-10;19427;8968;848620;235035
FR;2;2021-04-11;7808;4271;856428;239306
FR;2;2021-04-12;16754;11254;873182;250560
FR;2;2021-04-13;19005;16426;892187;266986
FR;2;2021-04-14;17565;16284;909752;283270
FR;2;2021-04-15;21771;20757;931523;304027
FR;2;2021-04-16;20257;20073;951780;324100
FR;2;2021-04-17;12962;22462;964742;346562
FR;2;2021-04-18;5766;14405;970508;360967
FR;2;2021-04-19;16378;16261;986886;377228
FR;2;2021-04-20;18862;21595;1005748;398823
FR;2;2021-04-21;18315;21665;1024063;420488
FR;2;2021-04-22;23155;24861;1047218;445349
FR;2;2021-04-23;23982;25346;1071200;470695
FR;2;2021-04-24;24951;15111;1096151;485806
FR;2;2021-04-25;9406;8589;1105557;494395
FR;2;2021-04-26;16583;17194;1122140;511589
FR;2;2021-04-27;18862;24305;1141002;535894
FR;2;2021-04-28;21458;26189;1162460;562083
FR;2;2021-04-29;24682;30136;1187142;592219
FR;2;2021-04-30;24949;27782;1212091;620001
FR;2;2021-05-01;14749;9863;1226840;629864
FR;2;2021-05-02;6475;9184;1233315;639048
FR;2;2021-05-03;19009;19327;1252324;658375
FR;2;2021-05-04;17834;29055;1270158;687430
FR;2;2021-05-05;17845;29417;1288003;716847
FR;2;2021-05-06;23054;35293;1311057;752140
FR;2;2021-05-07;23511;33243;1334568;785383
FR;2;2021-05-08;19207;9703;1353775;795086
FR;2;2021-05-09;12893;7894;1366668;802980
FR;2;2021-05-10;32019;22221;1398687;825201
FR;2;2021-05-11;42200;21078;1440887;846279
FR;2;2021-05-12;47074;19907;1487961;866186
FR;2;2021-05-13;50327;5770;1538288;871956
FR;2;2021-05-14;59694;12954;1597982;884910
FR;3;2020-12-27;0;0;0;0
FR;3;2020-12-28;0;0;0;0
FR;3;2020-12-29;0;0;0;0
FR;3;2020-12-30;0;0;0;0
FR;3;2020-12-31;0;0;0;0
FR;3;2021-01-01;0;0;0;0
FR;3;2021-01-02;0;0;0;0
FR;3;2021-01-03;0;0;0;0
FR;3;2021-01-04;0;0;0;0
FR;3;2021-01-05;0;0;0;0
FR;3;2021-01-06;0;0;0;0
FR;3;2021-01-07;0;0;0;0
FR;3;2021-01-08;0;0;0;0
FR;3;2021-01-09;0;0;0;0
FR;3;2021-01-10;0;0;0;0
FR;3;2021-01-11;0;0;0;0
FR;3;2021-01-12;0;0;0;0
FR;3;2021-01-13;0;0;0;0
FR;3;2021-01-14;0;0;0;0
FR;3;2021-01-15;0;0;0;0
FR;3;2021-01-16;0;0;0;0
FR;3;2021-01-17;0;0;0;0
FR;3;2021-01-18;0;0;0;0
FR;3;2021-01-19;0;0;0;0
FR;3;2021-01-20;0;0;0;0
FR;3;2021-01-21;0;0;0;0
FR;3;2021-01-22;0;0;0;0
FR;3;2021-01-23;0;0;0;0
FR;3;2021-01-24;0;0;0;0
FR;3;2021-01-25;0;0;0;0
FR;3;2021-01-26;0;0;0;0
FR;3;2021-01-27;0;0;0;0
FR;3;2021-01-28;0;0;0;0
FR;3;2021-01-29;0;0;0;0
FR;3;2021-01-30;0;0;0;0
FR;3;2021-01-31;0;0;0;0
FR;3;2021-02-01;0;0;0;0
FR;3;2021-02-02;0;0;0;0
FR;3;2021-02-03;0;0;0;0
FR;3;2021-02-04;0;0;0;0
FR;3;2021-02-05;0;0;0;0
FR;3;2021-02-06;298;0;298;0
FR;3;2021-02-07;1348;0;1646;0
FR;3;2021-02-08;2627;0;4273;0
FR;3;2021-02-09;6620;0;10893;0
FR;3;2021-02-10;9184;0;20077;0
FR;3;2021-02-11;13276;0;33353;0
FR;3;2021-02-12;12983;0;46336;0
FR;3;2021-02-13;3482;0;49818;0
FR;3;2021-02-14;859;0;50677;0
FR;3;2021-02-15;9994;0;60671;0
FR;3;2021-02-16;12111;0;72782;0
FR;3;2021-02-17;10767;0;83549;0
FR;3;2021-02-18;14431;0;97980;0
FR;3;2021-02-19;14003;0;111983;0
FR;3;2021-02-20;3139;0;115122;0
FR;3;2021-02-21;535;0;115657;0
FR;3;2021-02-22;8783;0;124440;0
FR;3;2021-02-23;10957;0;135397;0
FR;3;2021-02-24;13758;0;149155;0
FR;3;2021-02-25;43889;0;193044;0
FR;3;2021-02-26;60908;0;253952;0
FR;3;2021-02-27;34141;8;288093;8
FR;3;2021-02-28;2311;0;290404;8
FR;3;2021-03-01;19493;11;309897;19
FR;3;2021-03-02;37862;13;347759;32
FR;3;2021-03-03;47173;19;394932;51
FR;3;2021-03-04;79773;20;474705;71
FR;3;2021-03-05;115569;65;590274;136
FR;3;2021-03-06;116896;51;707170;187
FR;3;2021-03-07;53752;30;760922;217
FR;3;2021-03-08;41487;25;802409;242
FR;3;2021-03-09;77027;33;879436;275
FR;3;2021-03-10;78816;43;958252;318
FR;3;2021-03-11;125687;52;1083939;370
FR;3;2021-03-12;179428;71;1263367;441
FR;3;2021-03-13;129316;54;1392683;495
FR;3;2021-03-14;13589;6;1406272;501
FR;3;2021-03-15;50709;41;1456981;542
FR;3;2021-03-16;842;15;1457823;557
FR;3;2021-03-17;563;6;1458386;563
FR;3;2021-03-18;1088;4;1459474;567
FR;3;2021-03-19;68847;38;1528321;605
FR;3;2021-03-20;64017;36;1592338;641
FR;3;2021-03-21;5446;5;1597784;646
FR;3;2021-03-22;36388;34;1634172;680
FR;3;2021-03-23;83015;50;1717187;730
FR;3;2021-03-24;89252;91;1806439;821
FR;3;2021-03-25;147580;117;1954019;938
FR;3;2021-03-26;163064;156;2117083;1094
FR;3;2021-03-27;66981;88;2184064;1182
FR;3;2021-03-28;6137;19;2190201;1201
FR;3;2021-03-29;53160;61;2243361;1262
FR;3;2021-03-30;91776;88;2335137;1350
FR;3;2021-03-31;62168;82;2397305;1432
FR;3;2021-04-01;84432;105;2481737;1537
FR;3;2021-04-02;85550;148;2567287;1685
FR;3;2021-04-03;35137;110;2602424;1795
FR;3;2021-04-04;3372;15;2605796;1810
FR;3;2021-04-05;4199;21;2609995;1831
FR;3;2021-04-06;28820;76;2638815;1907
FR;3;2021-04-07;31454;60;2670269;1967
FR;3;2021-04-08;77358;235;2747627;2202
FR;3;2021-04-09;159547;411;2907174;2613
FR;3;2021-04-10;74312;333;2981486;2946
FR;3;2021-04-11;7000;44;2988486;2990
FR;3;2021-04-12;50418;197;3038904;3187
FR;3;2021-04-13;84927;316;3123831;3503
FR;3;2021-04-14;66403;342;3190234;3845
FR;3;2021-04-15;91506;371;3281740;4216
FR;3;2021-04-16;110833;574;3392573;4790
FR;3;2021-04-17;52124;337;3444697;5127
FR;3;2021-04-18;9417;35;3454114;5162
FR;3;2021-04-19;24370;239;3478484;5401
FR;3;2021-04-20;44704;399;3523188;5800
FR;3;2021-04-21;37952;458;3561140;6258
FR;3;2021-04-22;53511;794;3614651;7052
FR;3;2021-04-23;69226;1031;3683877;8083
FR;3;2021-04-24;36452;988;3720329;9071
FR;3;2021-04-25;5892;169;3726221;9240
FR;3;2021-04-26;19064;667;3745285;9907
FR;3;2021-04-27;33630;1246;3778915;11153
FR;3;2021-04-28;28177;1925;3807092;13078
FR;3;2021-04-29;44429;5958;3851521;19036
FR;3;2021-04-30;54398;8932;3905919;27968
FR;3;2021-05-01;9134;1968;3915053;29936
FR;3;2021-05-02;2796;500;3917849;30436
FR;3;2021-05-03;12453;3880;3930302;34316
FR;3;2021-05-04;22322;8454;3952624;42770
FR;3;2021-05-05;17903;10575;3970527;53345
FR;3;2021-05-06;33748;20907;4004275;74252
FR;3;2021-05-07;43086;28407;4047361;102659
FR;3;2021-05-08;6175;8911;4053536;111570
FR;3;2021-05-09;1545;2657;4055081;114227
FR;3;2021-05-10;14231;12561;4069312;126788
FR;3;2021-05-11;26193;25740;4095505;152528
FR;3;2021-05-12;16339;27452;4111844;179980
FR;3;2021-05-13;1904;3479;4113748;183459
FR;3;2021-05-14;13619;25745;4127367;209204
FR;4;2020-12-27;0;0;0;0
FR;4;2020-12-28;0;0;0;0
FR;4;2020-12-29;0;0;0;0
FR;4;2020-12-30;0;0;0;0
FR;4;2020-12-31;0;0;0;0
FR;4;2021-01-01;0;0;0;0
FR;4;2021-01-02;0;0;0;0
FR;4;2021-01-03;0;0;0;0
FR;4;2021-01-04;0;0;0;0
FR;4;2021-01-05;0;0;0;0
FR;4;2021-01-06;0;0;0;0
FR;4;2021-01-07;0;0;0;0
FR;4;2021-01-08;0;0;0;0
FR;4;2021-01-09;0;0;0;0
FR;4;2021-01-10;0;0;0;0
FR;4;2021-01-11;0;0;0;0
FR;4;2021-01-12;0;0;0;0
FR;4;2021-01-13;0;0;0;0
FR;4;2021-01-14;0;0;0;0
FR;4;2021-01-15;0;0;0;0
FR;4;2021-01-16;0;0;0;0
FR;4;2021-01-17;0;0;0;0
FR;4;2021-01-18;0;0;0;0
FR;4;2021-01-19;0;0;0;0
FR;4;2021-01-20;0;0;0;0
FR;4;2021-01-21;0;0;0;0
FR;4;2021-01-22;0;0;0;0
FR;4;2021-01-23;0;0;0;0
FR;4;2021-01-24;0;0;0;0
FR;4;2021-01-25;0;0;0;0
FR;4;2021-01-26;0;0;0;0
FR;4;2021-01-27;0;0;0;0
FR;4;2021-01-28;0;0;0;0
FR;4;2021-01-29;0;0;0;0
FR;4;2021-01-30;0;0;0;0
FR;4;2021-01-31;0;0;0;0
FR;4;2021-02-01;0;0;0;0
FR;4;2021-02-02;0;0;0;0
FR;4;2021-02-03;0;0;0;0
FR;4;2021-02-04;0;0;0;0
FR;4;2021-02-05;0;0;0;0
FR;4;2021-02-06;0;0;0;0
FR;4;2021-02-07;0;0;0;0
FR;4;2021-02-08;0;0;0;0
FR;4;2021-02-09;0;0;0;0
FR;4;2021-02-10;0;0;0;0
FR;4;2021-02-11;0;0;0;0
FR;4;2021-02-12;0;0;0;0
FR;4;2021-02-13;0;0;0;0
FR;4;2021-02-14;0;0;0;0
FR;4;2021-02-15;0;0;0;0
FR;4;2021-02-16;0;0;0;0
FR;4;2021-02-17;0;0;0;0
FR;4;2021-02-18;0;0;0;0
FR;4;2021-02-19;0;0;0;0
FR;4;2021-02-20;0;0;0;0
FR;4;2021-02-21;0;0;0;0
FR;4;2021-02-22;0;0;0;0
FR;4;2021-02-23;0;0;0;0
FR;4;2021-02-24;0;0;0;0
FR;4;2021-02-25;0;0;0;0
FR;4;2021-02-26;0;0;0;0
FR;4;2021-02-27;0;0;0;0
FR;4;2021-02-28;0;0;0;0
FR;4;2021-03-01;0;0;0;0
FR;4;2021-03-02;0;0;0;0
FR;4;2021-03-03;0;0;0;0
FR;4;2021-03-04;0;0;0;0
FR;4;2021-03-05;0;0;0;0
FR;4;2021-03-06;0;0;0;0
FR;4;2021-03-07;0;0;0;0
FR;4;2021-03-08;0;0;0;0
FR;4;2021-03-09;0;0;0;0
FR;4;2021-03-10;0;0;0;0
FR;4;2021-03-11;0;0;0;0
FR;4;2021-03-12;0;0;0;0
FR;4;2021-03-13;0;0;0;0
FR;4;2021-03-14;0;0;0;0
FR;4;2021-03-15;0;0;0;0
FR;4;2021-03-16;0;0;0;0
FR;4;2021-03-17;0;0;0;0
FR;4;2021-03-18;0;0;0;0
FR;4;2021-03-19;0;0;0;0
FR;4;2021-03-20;0;0;0;0
FR;4;2021-03-21;0;0;0;0
FR;4;2021-03-22;0;0;0;0
FR;4;2021-03-23;0;0;0;0
FR;4;2021-03-24;0;0;0;0
FR;4;2021-03-25;0;0;0;0
FR;4;2021-03-26;0;0;0;0
FR;4;2021-03-27;0;0;0;0
FR;4;2021-03-28;0;0;0;0
FR;4;2021-03-29;0;0;0;0
FR;4;2021-03-30;0;0;0;0
FR;4;2021-03-31;0;0;0;0
FR;4;2021-04-01;0;0;0;0
FR;4;2021-04-02;0;0;0;0
FR;4;2021-04-03;0;0;0;0
FR;4;2021-04-04;0;0;0;0
FR;4;2021-04-05;0;0;0;0
FR;4;2021-04-06;0;0;0;0
FR;4;2021-04-07;0;0;0;0
FR;4;2021-04-08;0;0;0;0
FR;4;2021-04-09;0;0;0;0
FR;4;2021-04-10;0;0;0;0
FR;4;2021-04-11;0;0;0;0
FR;4;2021-04-12;0;0;0;0
FR;4;2021-04-13;0;0;0;0
FR;4;2021-04-14;0;0;0;0
FR;4;2021-04-15;0;0;0;0
FR;4;2021-04-16;0;0;0;0
FR;4;2021-04-17;0;0;0;0
FR;4;2021-04-18;0;0;0;0
FR;4;2021-04-19;0;0;0;0
FR;4;2021-04-20;0;0;0;0
FR;4;2021-04-21;0;0;0;0
FR;4;2021-04-22;0;0;0;0
FR;4;2021-04-23;505;0;505;0
FR;4;2021-04-24;1554;0;2059;0
FR;4;2021-04-25;117;0;2176;0
FR;4;2021-04-26;2818;0;4994;0
FR;4;2021-04-27;9348;3;14342;3
FR;4;2021-04-28;9738;3;24080;6
FR;4;2021-04-29;15836;7;39916;13
FR;4;2021-04-30;19021;7;58937;20
FR;4;2021-05-01;1873;5;60810;25
FR;4;2021-05-02;432;0;61242;25
FR;4;2021-05-03;4893;1;66135;26
FR;4;2021-05-04;8225;8;74360;34
FR;4;2021-05-05;5963;7;80323;41
FR;4;2021-05-06;11195;13;91518;54
FR;4;2021-05-07;18798;10;110316;64
FR;4;2021-05-08;2218;4;112534;68
FR;4;2021-05-09;625;2;113159;70
FR;4;2021-05-10;7010;11;120169;81
FR;4;2021-05-11;13959;11;134128;92
FR;4;2021-05-12;9752;13;143880;105
FR;4;2021-05-13;1404;3;145284;108
FR;4;2021-05-14;7280;8;152564;116
FR;0;2020-12-27;20;0;20;0
FR;0;2020-12-28;63;0;83;0
FR;0;2020-12-29;108;0;191;0
FR;0;2020-12-30;119;0;310;0
FR;0;2020-12-31;83;0;393;0
FR;0;2021-01-01;65;0;458;0
FR;0;2021-01-02;76;0;534;0
FR;0;2021-01-03;87;0;621;0
FR;0;2021-01-04;1468;0;2089;0
FR;0;2021-01-05;5378;0;7467;0
FR;0;2021-01-06;11278;0;18745;0
FR;0;2021-01-07;28526;0;47271;0
FR;0;2021-01-08;36034;0;83305;0
FR;0;2021-01-09;10884;0;94189;0
FR;0;2021-01-10;5602;0;99791;0
FR;0;2021-01-11;38841;0;138632;0
FR;0;2021-01-12;60606;0;199238;0
FR;0;2021-01-13;63546;0;262784;0
FR;0;2021-01-14;79634;0;342418;0
FR;0;2021-01-15;67179;0;409597;0
FR;0;2021-01-16;19594;78;429191;78
FR;0;2021-01-17;10452;42;439643;120
FR;0;2021-01-18;84248;163;523891;283
FR;0;2021-01-19;128177;127;652068;410
FR;0;2021-01-20;134779;159;786847;569
FR;0;2021-01-21;154828;135;941675;704
FR;0;2021-01-22;118189;162;1059864;866
FR;0;2021-01-23;37745;50;1097609;916
FR;0;2021-01-24;9332;27;1106941;943
FR;0;2021-01-25;76649;1218;1183590;2161
FR;0;2021-01-26;98589;3110;1282179;5271
FR;0;2021-01-27;105446;5597;1387625;10868
FR;0;2021-01-28;122004;14360;1509629;25228
FR;0;2021-01-29;90758;17293;1600387;42521
FR;0;2021-01-30;28620;4225;1629007;46746
FR;0;2021-01-31;4862;1679;1633869;48425
FR;0;2021-02-01;51406;21128;1685275;69553
FR;0;2021-02-02;70398;34568;1755673;104121
FR;0;2021-02-03;70833;36960;1826506;141081
FR;0;2021-02-04;80241;50060;1906747;191141
FR;0;2021-02-05;66851;45341;1973598;236482
FR;0;2021-02-06;21258;10399;1994856;246881
FR;0;2021-02-07;4826;5041;1999682;251922
FR;0;2021-02-08;45773;45993;2045455;297915
FR;0;2021-02-09;64639;72407;2110094;370322
FR;0;2021-02-10;69104;76695;2179198;447017
FR;0;2021-02-11;85332;99144;2264530;546161
FR;0;2021-02-12;77498;74276;2342028;620437
FR;0;2021-02-13;21597;19492;2363625;639929
FR;0;2021-02-14;4564;7190;2368189;647119
FR;0;2021-02-15;36874;76507;2405063;723626
FR;0;2021-02-16;49085;100746;2454148;824372
FR;0;2021-02-17;49201;102971;2503349;927343
FR;0;2021-02-18;67609;118562;2570958;1045905
FR;0;2021-02-19;63463;90735;2634421;1136640
FR;0;2021-02-20;17909;28428;2652330;1165068
FR;0;2021-02-21;2841;6373;2655171;1171441
FR;0;2021-02-22;36275;73137;2691446;1244578
FR;0;2021-02-23;52266;84058;2743712;1328636
FR;0;2021-02-24;57800;81129;2801512;1409765
FR;0;2021-02-25;97893;91420;2899405;1501185
FR;0;2021-02-26;111064;71011;3010469;1572196
FR;0;2021-02-27;50807;21980;3061276;1594176
FR;0;2021-02-28;5636;4414;3066912;1598590
FR;0;2021-03-01;63109;52804;3130021;1651394
FR;0;2021-03-02;98719;66246;3228740;1717640
FR;0;2021-03-03;112716;65551;3341456;1783191
FR;0;2021-03-04;158703;68881;3500159;1852072
FR;0;2021-03-05;196326;63393;3696485;1915465
FR;0;2021-03-06;202770;17824;3899255;1933289
FR;0;2021-03-07;118980;5481;4018235;1938770
FR;0;2021-03-08;104105;50808;4122340;1989578
FR;0;2021-03-09;168519;56778;4290859;2046356
FR;0;2021-03-10;174441;57215;4465300;2103571
FR;0;2021-03-11;237719;63118;4703019;2166689
FR;0;2021-03-12;289102;53506;4992121;2220195
FR;0;2021-03-13;226653;15284;5218774;2235479
FR;0;2021-03-14;61960;3437;5280734;2238916
FR;0;2021-03-15;154916;32673;5435650;2271589
FR;0;2021-03-16;138984;39541;5574634;2311130
FR;0;2021-03-17;147594;38826;5722228;2349956
FR;0;2021-03-18;164571;44664;5886799;2394620
FR;0;2021-03-19;225714;37486;6112513;2432106
FR;0;2021-03-20;164021;11787;6276534;2443893
FR;0;2021-03-21;48676;2628;6325210;2446521
FR;0;2021-03-22;166538;34300;6491748;2480821
FR;0;2021-03-23;245855;42406;6737603;2523227
FR;0;2021-03-24;252379;43869;6989982;2567096
FR;0;2021-03-25;336212;44754;7326194;2611850
FR;0;2021-03-26;353509;41911;7679703;2653761
FR;0;2021-03-27;192342;16653;7872045;2670414
FR;0;2021-03-28;58228;3737;7930273;2674151
FR;0;2021-03-29;199794;54310;8130067;2728461
FR;0;2021-03-30;281005;69686;8411072;2798147
FR;0;2021-03-31;258373;72951;8669445;2871098
FR;0;2021-04-01;308541;87852;8977986;2958950
FR;0;2021-04-02;276747;92127;9254733;3051077
FR;0;2021-04-03;138817;61876;9393550;3112953
FR;0;2021-04-04;44795;18665;9438345;3131618
FR;0;2021-04-05;58668;11009;9497013;3142627
FR;0;2021-04-06;212218;107897;9709231;3250524
FR;0;2021-04-07;255198;115503;9964429;3366027
FR;0;2021-04-08;331307;121458;10295736;3487485
FR;0;2021-04-09;402796;116530;10698532;3604015
FR;0;2021-04-10;209688;82763;10908220;3686778
FR;0;2021-04-11;54867;34603;10963087;3721381
FR;0;2021-04-12;232831;115247;11195918;3836628
FR;0;2021-04-13;303712;144998;11499630;3981626
FR;0;2021-04-14;287774;139445;11787404;4121071
FR;0;2021-04-15;329084;147886;12116488;4268957
FR;0;2021-04-16;332725;145795;12449213;4414752
FR;0;2021-04-17;185044;90278;12634257;4505030
FR;0;2021-04-18;50118;35432;12684375;4540462
FR;0;2021-04-19;201038;138428;12885413;4678890
FR;0;2021-04-20;248205;170790;13133618;4849680
FR;0;2021-04-21;245572;168873;13379190;5018553
FR;0;2021-04-22;280318;188302;13659508;5206855
FR;0;2021-04-23;287551;183307;13947059;5390162
FR;0;2021-04-24;186738;111605;14133797;5501767
FR;0;2021-04-25;67272;38887;14201069;5540654
FR;0;2021-04-26;213453;156140;14414522;5696794
FR;0;2021-04-27;278289;187562;14692811;5884356
FR;0;2021-04-28;292624;183253;14985435;6067609
FR;0;2021-04-29;347763;196193;15333198;6263802
FR;0;2021-04-30;363593;184897;15696791;6448699
FR;0;2021-05-01;159101;52554;15855892;6501253
FR;0;2021-05-02;89193;37847;15945085;6539100
FR;0;2021-05-03;279328;169755;16224413;6708855
FR;0;2021-05-04;305559;224394;16529972;6933249
FR;0;2021-05-05;314025;224597;16843997;7157846
FR;0;2021-05-06;366995;239281;17210992;7397127
FR;0;2021-05-07;360193;257422;17571185;7654549
FR;0;2021-05-08;198832;66946;17770017;7721495
FR;0;2021-05-09;127040;46785;17897057;7768280
FR;0;2021-05-10;297777;229086;18194834;7997366
FR;0;2021-05-11;389690;258281;18584524;8255647
FR;0;2021-05-12;410204;233331;18994728;8488978
FR;0;2021-05-13;325039;56935;19319767;8545913
FR;0;2021-05-14;434484;167644;19754251;8713557
