fra;vaccin;jour;n_dose1;n_dose2;n_cum_dose1;n_cum_dose2
FR;1;2020-12-27;17;0;17;0
FR;1;2020-12-28;59;0;76;0
FR;1;2020-12-29;107;0;183;0
FR;1;2020-12-30;115;0;298;0
FR;1;2020-12-31;83;0;381;0
FR;1;2021-01-01;55;0;436;0
FR;1;2021-01-02;71;0;507;0
FR;1;2021-01-03;87;0;594;0
FR;1;2021-01-04;1462;0;2056;0
FR;1;2021-01-05;5352;0;7408;0
FR;1;2021-01-06;11247;0;18655;0
FR;1;2021-01-07;28447;0;47102;0
FR;1;2021-01-08;35878;0;82980;0
FR;1;2021-01-09;10865;0;93845;0
FR;1;2021-01-10;5599;0;99444;0
FR;1;2021-01-11;38711;0;138155;0
FR;1;2021-01-12;60303;0;198458;0
FR;1;2021-01-13;63328;0;261786;0
FR;1;2021-01-14;79279;0;341065;0
FR;1;2021-01-15;66654;0;407719;0
FR;1;2021-01-16;19386;651;427105;651
FR;1;2021-01-17;10443;40;437548;691
FR;1;2021-01-18;81157;187;518705;878
FR;1;2021-01-19;123264;227;641969;1105
FR;1;2021-01-20;129599;154;771568;1259
FR;1;2021-01-21;149441;156;921009;1415
FR;1;2021-01-22;113019;222;1034028;1637
FR;1;2021-01-23;35984;83;1070012;1720
FR;1;2021-01-24;9234;104;1079246;1824
FR;1;2021-01-25;72927;1498;1152173;3322
FR;1;2021-01-26;94556;3923;1246729;7245
FR;1;2021-01-27;101913;6795;1348642;14040
FR;1;2021-01-28;118295;17505;1466937;31545
FR;1;2021-01-29;87529;19612;1554466;51157
FR;1;2021-01-30;27540;4660;1582006;55817
FR;1;2021-01-31;4855;1907;1586861;57724
FR;1;2021-02-01;48095;24110;1634956;81834
FR;1;2021-02-02;65977;40618;1700933;122452
FR;1;2021-02-03;65713;41851;1766646;164303
FR;1;2021-02-04;75392;58538;1842038;222841
FR;1;2021-02-05;62184;49440;1904222;272281
FR;1;2021-02-06;19022;11372;1923244;283653
FR;1;2021-02-07;3426;6447;1926670;290100
FR;1;2021-02-08;35688;49997;1962358;340097
FR;1;2021-02-09;49703;82156;2012061;422253
FR;1;2021-02-10;50709;87089;2062770;509342
FR;1;2021-02-11;61847;109748;2124617;619090
FR;1;2021-02-12;54639;75295;2179256;694385
FR;1;2021-02-13;15087;18446;2194343;712831
FR;1;2021-02-14;3403;6746;2197746;719577
FR;1;2021-02-15;23468;71835;2221214;791412
FR;1;2021-02-16;31926;92204;2253140;883616
FR;1;2021-02-17;34271;103154;2287411;986770
FR;1;2021-02-18;47818;120085;2335229;1106855
FR;1;2021-02-19;44248;86315;2379477;1193170
FR;1;2021-02-20;12994;26138;2392471;1219308
FR;1;2021-02-21;2108;5294;2394579;1224602
FR;1;2021-02-22;23937;66920;2418516;1291522
FR;1;2021-02-23;36439;79818;2454955;1371340
FR;1;2021-02-24;39221;78924;2494176;1450264
FR;1;2021-02-25;48607;85089;2542783;1535353
FR;1;2021-02-26;45897;65824;2588680;1601177
FR;1;2021-02-27;15154;20989;2603834;1622166
FR;1;2021-02-28;3225;3569;2607059;1625735
FR;1;2021-03-01;38579;48644;2645638;1674379
FR;1;2021-03-02;54446;61576;2700084;1735955
FR;1;2021-03-03;59226;59259;2759310;1795214
FR;1;2021-03-04;70595;68827;2829905;1864041
FR;1;2021-03-05;72827;57062;2902732;1921103
FR;1;2021-03-06;81210;14998;2983942;1936101
FR;1;2021-03-07;62909;2337;3046851;1938438
FR;1;2021-03-08;58554;38382;3105405;1976820
FR;1;2021-03-09;84060;45311;3189465;2022131
FR;1;2021-03-10;88627;46332;3278092;2068463
FR;1;2021-03-11;102664;53500;3380756;2121963
FR;1;2021-03-12;101749;43489;3482505;2165452
FR;1;2021-03-13;87441;12079;3569946;2177531
FR;1;2021-03-14;43597;2097;3613543;2179628
FR;1;2021-03-15;93487;25847;3707030;2205475
FR;1;2021-03-16;121537;32266;3828567;2237741
FR;1;2021-03-17;126958;31795;3955525;2269536
FR;1;2021-03-18;140323;37513;4095848;2307049
FR;1;2021-03-19;133761;30209;4229609;2337258
FR;1;2021-03-20;74800;9204;4304409;2346462
FR;1;2021-03-21;25741;1338;4330150;2347800
FR;1;2021-03-22;112520;28528;4442670;2376328
FR;1;2021-03-23;140282;36420;4582952;2412748
FR;1;2021-03-24;139387;36944;4722339;2449692
FR;1;2021-03-25;161976;38862;4884315;2488554
FR;1;2021-03-26;163350;36005;5047665;2524559
FR;1;2021-03-27;109529;15112;5157194;2539671
FR;1;2021-03-28;41313;4560;5198507;2544231
FR;1;2021-03-29;126620;47053;5325127;2591284
FR;1;2021-03-30;162550;62735;5487677;2654019
FR;1;2021-03-31;166037;67346;5653714;2721365
FR;1;2021-04-01;186157;84637;5839871;2806002
FR;1;2021-04-02;159974;87339;5999845;2893341
FR;1;2021-04-03;86356;57757;6086201;2951098
FR;1;2021-04-04;32088;17462;6118289;2968560
FR;1;2021-04-05;42094;9008;6160383;2977568
FR;1;2021-04-06;151739;105287;6312122;3082855
FR;1;2021-04-07;190328;106351;6502450;3189206
FR;1;2021-04-08;213460;113025;6715910;3302231
FR;1;2021-04-09;206558;106786;6922468;3409017
FR;1;2021-04-10;115009;72203;7037477;3481220
FR;1;2021-04-11;39863;29205;7077340;3510425
FR;1;2021-04-12;163876;102345;7241216;3612770
FR;1;2021-04-13;197293;124182;7438509;3736952
FR;1;2021-04-14;201604;120401;7640113;3857353
FR;1;2021-04-15;213001;125553;7853114;3982906
FR;1;2021-04-16;198707;122885;8051821;4105791
FR;1;2021-04-17;119435;65961;8171256;4171752
FR;1;2021-04-18;34829;20657;8206085;4192409
FR;1;2021-04-19;158103;119026;8364188;4311435
FR;1;2021-04-20;181924;145863;8546112;4457298
FR;1;2021-04-21;186294;144300;8732406;4601598
FR;1;2021-04-22;197409;159491;8929815;4761089
FR;1;2021-04-23;186558;152769;9116373;4913858
FR;1;2021-04-24;122352;93611;9238725;5007469
FR;2;2020-12-27;0;0;0;0
FR;2;2020-12-28;0;0;0;0
FR;2;2020-12-29;0;0;0;0
FR;2;2020-12-30;0;0;0;0
FR;2;2020-12-31;0;0;0;0
FR;2;2021-01-01;0;0;0;0
FR;2;2021-01-02;0;0;0;0
FR;2;2021-01-03;0;0;0;0
FR;2;2021-01-04;0;0;0;0
FR;2;2021-01-05;0;0;0;0
FR;2;2021-01-06;0;0;0;0
FR;2;2021-01-07;0;0;0;0
FR;2;2021-01-08;0;0;0;0
FR;2;2021-01-09;0;0;0;0
FR;2;2021-01-10;0;0;0;0
FR;2;2021-01-11;0;0;0;0
FR;2;2021-01-12;0;0;0;0
FR;2;2021-01-13;0;0;0;0
FR;2;2021-01-14;140;0;140;0
FR;2;2021-01-15;218;0;358;0
FR;2;2021-01-16;185;0;543;0
FR;2;2021-01-17;3;0;546;0
FR;2;2021-01-18;2900;0;3446;0
FR;2;2021-01-19;4480;0;7926;0
FR;2;2021-01-20;4903;0;12829;0
FR;2;2021-01-21;5060;0;17889;0
FR;2;2021-01-22;4852;0;22741;0
FR;2;2021-01-23;1726;0;24467;0
FR;2;2021-01-24;81;0;24548;0
FR;2;2021-01-25;3628;0;28176;0
FR;2;2021-01-26;3687;0;31863;0
FR;2;2021-01-27;3401;0;35264;0
FR;2;2021-01-28;3479;0;38743;0
FR;2;2021-01-29;3071;0;41814;0
FR;2;2021-01-30;1054;0;42868;0
FR;2;2021-01-31;0;0;42868;0
FR;2;2021-02-01;3245;0;46113;0
FR;2;2021-02-02;4300;0;50413;0
FR;2;2021-02-03;5029;0;55442;0
FR;2;2021-02-04;4653;3;60095;3
FR;2;2021-02-05;4549;6;64644;9
FR;2;2021-02-06;1928;2;66572;11
FR;2;2021-02-07;37;0;66609;11
FR;2;2021-02-08;7411;11;74020;22
FR;2;2021-02-09;8249;15;82269;37
FR;2;2021-02-10;9130;50;91399;87
FR;2;2021-02-11;10043;121;101442;208
FR;2;2021-02-12;9755;256;111197;464
FR;2;2021-02-13;3007;205;114204;669
FR;2;2021-02-14;296;1;114500;670
FR;2;2021-02-15;3351;3120;117851;3790
FR;2;2021-02-16;4900;4211;122751;8001
FR;2;2021-02-17;4085;4581;126836;12582
FR;2;2021-02-18;5216;5141;132052;17723
FR;2;2021-02-19;5093;4483;137145;22206
FR;2;2021-02-20;1763;1498;138908;23704
FR;2;2021-02-21;197;86;139105;23790
FR;2;2021-02-22;3505;3775;142610;27565
FR;2;2021-02-23;4783;3697;147393;31262
FR;2;2021-02-24;4734;3519;152127;34781
FR;2;2021-02-25;5260;3401;157387;38182
FR;2;2021-02-26;4189;3095;161576;41277
FR;2;2021-02-27;1500;1059;163076;42336
FR;2;2021-02-28;99;3;163175;42339
FR;2;2021-03-01;4943;3722;168118;46061
FR;2;2021-03-02;6284;4644;174402;50705
FR;2;2021-03-03;6237;4916;180639;55621
FR;2;2021-03-04;8054;4136;188693;59757
FR;2;2021-03-05;7752;3913;196445;63670
FR;2;2021-03-06;4617;1661;201062;65331
FR;2;2021-03-07;2279;23;203341;65354
FR;2;2021-03-08;3967;8334;207308;73688
FR;2;2021-03-09;7248;8546;214556;82234
FR;2;2021-03-10;6836;9158;221392;91392
FR;2;2021-03-11;8993;9346;230385;100738
FR;2;2021-03-12;7681;8261;238066;108999
FR;2;2021-03-13;9840;2569;247906;111568
FR;2;2021-03-14;4751;343;252657;111911
FR;2;2021-03-15;10616;3408;263273;115319
FR;2;2021-03-16;16391;4715;279664;120034
FR;2;2021-03-17;19730;3983;299394;124017
FR;2;2021-03-18;22815;5128;322209;129145
FR;2;2021-03-19;22746;4622;344955;133767
FR;2;2021-03-20;25124;1593;370079;135360
FR;2;2021-03-21;17457;146;387536;135506
FR;2;2021-03-22;17316;3308;404852;138814
FR;2;2021-03-23;22240;4311;427092;143125
FR;2;2021-03-24;23471;5052;450563;148177
FR;2;2021-03-25;26187;5220;476750;153397
FR;2;2021-03-26;26509;4162;503259;157559
FR;2;2021-03-27;15614;1398;518873;158957
FR;2;2021-03-28;10244;144;529117;159101
FR;2;2021-03-29;18457;4289;547574;163390
FR;2;2021-03-30;23937;6058;571511;169448
FR;2;2021-03-31;27709;5810;599220;175258
FR;2;2021-04-01;33313;8405;632533;183663
FR;2;2021-04-02;28944;7696;661477;191359
FR;2;2021-04-03;16367;4470;677844;195829
FR;2;2021-04-04;9093;1375;686937;197204
FR;2;2021-04-05;12024;738;698961;197942
FR;2;2021-04-06;26149;7450;725110;205392
FR;2;2021-04-07;30157;6945;755267;212337
FR;2;2021-04-08;35992;8380;791259;220717
FR;2;2021-04-09;33067;8151;824326;228868
FR;2;2021-04-10;19358;9304;843684;238172
FR;2;2021-04-11;7784;4215;851468;242387
FR;2;2021-04-12;16625;10786;868093;253173
FR;2;2021-04-13;18826;15733;886919;268906
FR;2;2021-04-14;17469;16350;904388;285256
FR;2;2021-04-15;21620;20281;926008;305537
FR;2;2021-04-16;19666;20097;945674;325634
FR;2;2021-04-17;12932;22353;958606;347987
FR;2;2021-04-18;5753;14342;964359;362329
FR;2;2021-04-19;16309;16168;980668;378497
FR;2;2021-04-20;18690;21764;999358;400261
FR;2;2021-04-21;17549;21474;1016907;421735
FR;2;2021-04-22;22910;24424;1039817;446159
FR;2;2021-04-23;23779;24997;1063596;471156
FR;2;2021-04-24;24791;14633;1088387;485789
FR;3;2020-12-27;0;0;0;0
FR;3;2020-12-28;0;0;0;0
FR;3;2020-12-29;0;0;0;0
FR;3;2020-12-30;0;0;0;0
FR;3;2020-12-31;0;0;0;0
FR;3;2021-01-01;0;0;0;0
FR;3;2021-01-02;0;0;0;0
FR;3;2021-01-03;0;0;0;0
FR;3;2021-01-04;0;0;0;0
FR;3;2021-01-05;0;0;0;0
FR;3;2021-01-06;0;0;0;0
FR;3;2021-01-07;0;0;0;0
FR;3;2021-01-08;0;0;0;0
FR;3;2021-01-09;0;0;0;0
FR;3;2021-01-10;0;0;0;0
FR;3;2021-01-11;0;0;0;0
FR;3;2021-01-12;0;0;0;0
FR;3;2021-01-13;0;0;0;0
FR;3;2021-01-14;0;0;0;0
FR;3;2021-01-15;0;0;0;0
FR;3;2021-01-16;0;0;0;0
FR;3;2021-01-17;0;0;0;0
FR;3;2021-01-18;0;0;0;0
FR;3;2021-01-19;0;0;0;0
FR;3;2021-01-20;0;0;0;0
FR;3;2021-01-21;0;0;0;0
FR;3;2021-01-22;0;0;0;0
FR;3;2021-01-23;0;0;0;0
FR;3;2021-01-24;0;0;0;0
FR;3;2021-01-25;0;0;0;0
FR;3;2021-01-26;0;0;0;0
FR;3;2021-01-27;0;0;0;0
FR;3;2021-01-28;0;0;0;0
FR;3;2021-01-29;0;0;0;0
FR;3;2021-01-30;0;0;0;0
FR;3;2021-01-31;0;0;0;0
FR;3;2021-02-01;0;0;0;0
FR;3;2021-02-02;0;0;0;0
FR;3;2021-02-03;0;0;0;0
FR;3;2021-02-04;0;0;0;0
FR;3;2021-02-05;0;0;0;0
FR;3;2021-02-06;256;0;256;0
FR;3;2021-02-07;1347;0;1603;0
FR;3;2021-02-08;2593;0;4196;0
FR;3;2021-02-09;6548;0;10744;0
FR;3;2021-02-10;8993;0;19737;0
FR;3;2021-02-11;13087;0;32824;0
FR;3;2021-02-12;12762;0;45586;0
FR;3;2021-02-13;3441;0;49027;0
FR;3;2021-02-14;840;0;49867;0
FR;3;2021-02-15;9924;0;59791;0
FR;3;2021-02-16;11965;0;71756;0
FR;3;2021-02-17;10657;0;82413;0
FR;3;2021-02-18;14147;0;96560;0
FR;3;2021-02-19;13872;0;110432;0
FR;3;2021-02-20;3091;0;113523;0
FR;3;2021-02-21;531;0;114054;0
FR;3;2021-02-22;8689;0;122743;0
FR;3;2021-02-23;10857;0;133600;0
FR;3;2021-02-24;13581;0;147181;0
FR;3;2021-02-25;43638;0;190819;0
FR;3;2021-02-26;60542;0;251361;0
FR;3;2021-02-27;33948;8;285309;8
FR;3;2021-02-28;2292;0;287601;8
FR;3;2021-03-01;19333;28;306934;36
FR;3;2021-03-02;37669;12;344603;48
FR;3;2021-03-03;46808;21;391411;69
FR;3;2021-03-04;79117;26;470528;95
FR;3;2021-03-05;114872;70;585400;165
FR;3;2021-03-06;116127;56;701527;221
FR;3;2021-03-07;53587;30;755114;251
FR;3;2021-03-08;41248;24;796362;275
FR;3;2021-03-09;76695;39;873057;314
FR;3;2021-03-10;78468;45;951525;359
FR;3;2021-03-11;125269;59;1076794;418
FR;3;2021-03-12;178789;74;1255583;492
FR;3;2021-03-13;128961;54;1384544;546
FR;3;2021-03-14;13563;5;1398107;551
FR;3;2021-03-15;50528;43;1448635;594
FR;3;2021-03-16;826;10;1449461;604
FR;3;2021-03-17;549;5;1450010;609
FR;3;2021-03-18;1075;3;1451085;612
FR;3;2021-03-19;68701;42;1519786;654
FR;3;2021-03-20;63897;36;1583683;690
FR;3;2021-03-21;5434;5;1589117;695
FR;3;2021-03-22;36325;30;1625442;725
FR;3;2021-03-23;82940;51;1708382;776
FR;3;2021-03-24;89158;76;1797540;852
FR;3;2021-03-25;147332;122;1944872;974
FR;3;2021-03-26;162801;161;2107673;1135
FR;3;2021-03-27;66895;87;2174568;1222
FR;3;2021-03-28;6083;17;2180651;1239
FR;3;2021-03-29;53107;61;2233758;1300
FR;3;2021-03-30;91654;89;2325412;1389
FR;3;2021-03-31;62114;79;2387526;1468
FR;3;2021-04-01;84208;109;2471734;1577
FR;3;2021-04-02;85403;154;2557137;1731
FR;3;2021-04-03;35061;121;2592198;1852
FR;3;2021-04-04;3330;15;2595528;1867
FR;3;2021-04-05;4183;21;2599711;1888
FR;3;2021-04-06;28729;66;2628440;1954
FR;3;2021-04-07;31411;52;2659851;2006
FR;3;2021-04-08;77196;240;2737047;2246
FR;3;2021-04-09;159134;417;2896181;2663
FR;3;2021-04-10;74127;334;2970308;2997
FR;3;2021-04-11;6985;44;2977293;3041
FR;3;2021-04-12;50289;186;3027582;3227
FR;3;2021-04-13;84633;344;3112215;3571
FR;3;2021-04-14;66201;328;3178416;3899
FR;3;2021-04-15;91116;379;3269532;4278
FR;3;2021-04-16;110224;586;3379756;4864
FR;3;2021-04-17;51851;342;3431607;5206
FR;3;2021-04-18;9375;39;3440982;5245
FR;3;2021-04-19;24240;236;3465222;5481
FR;3;2021-04-20;44495;400;3509717;5881
FR;3;2021-04-21;37686;454;3547403;6335
FR;3;2021-04-22;52888;799;3600291;7134
FR;3;2021-04-23;67950;1015;3668241;8149
FR;3;2021-04-24;35514;987;3703755;9136
FR;4;2020-12-27;0;0;0;0
FR;4;2020-12-28;0;0;0;0
FR;4;2020-12-29;0;0;0;0
FR;4;2020-12-30;0;0;0;0
FR;4;2020-12-31;0;0;0;0
FR;4;2021-01-01;0;0;0;0
FR;4;2021-01-02;0;0;0;0
FR;4;2021-01-03;0;0;0;0
FR;4;2021-01-04;0;0;0;0
FR;4;2021-01-05;0;0;0;0
FR;4;2021-01-06;0;0;0;0
FR;4;2021-01-07;0;0;0;0
FR;4;2021-01-08;0;0;0;0
FR;4;2021-01-09;0;0;0;0
FR;4;2021-01-10;0;0;0;0
FR;4;2021-01-11;0;0;0;0
FR;4;2021-01-12;0;0;0;0
FR;4;2021-01-13;0;0;0;0
FR;4;2021-01-14;0;0;0;0
FR;4;2021-01-15;0;0;0;0
FR;4;2021-01-16;0;0;0;0
FR;4;2021-01-17;0;0;0;0
FR;4;2021-01-18;0;0;0;0
FR;4;2021-01-19;0;0;0;0
FR;4;2021-01-20;0;0;0;0
FR;4;2021-01-21;0;0;0;0
FR;4;2021-01-22;0;0;0;0
FR;4;2021-01-23;0;0;0;0
FR;4;2021-01-24;0;0;0;0
FR;4;2021-01-25;0;0;0;0
FR;4;2021-01-26;0;0;0;0
FR;4;2021-01-27;0;0;0;0
FR;4;2021-01-28;0;0;0;0
FR;4;2021-01-29;0;0;0;0
FR;4;2021-01-30;0;0;0;0
FR;4;2021-01-31;0;0;0;0
FR;4;2021-02-01;0;0;0;0
FR;4;2021-02-02;0;0;0;0
FR;4;2021-02-03;0;0;0;0
FR;4;2021-02-04;0;0;0;0
FR;4;2021-02-05;0;0;0;0
FR;4;2021-02-06;0;0;0;0
FR;4;2021-02-07;0;0;0;0
FR;4;2021-02-08;0;0;0;0
FR;4;2021-02-09;0;0;0;0
FR;4;2021-02-10;0;0;0;0
FR;4;2021-02-11;0;0;0;0
FR;4;2021-02-12;0;0;0;0
FR;4;2021-02-13;0;0;0;0
FR;4;2021-02-14;0;0;0;0
FR;4;2021-02-15;0;0;0;0
FR;4;2021-02-16;0;0;0;0
FR;4;2021-02-17;0;0;0;0
FR;4;2021-02-18;0;0;0;0
FR;4;2021-02-19;0;0;0;0
FR;4;2021-02-20;0;0;0;0
FR;4;2021-02-21;0;0;0;0
FR;4;2021-02-22;0;0;0;0
FR;4;2021-02-23;0;0;0;0
FR;4;2021-02-24;0;0;0;0
FR;4;2021-02-25;0;0;0;0
FR;4;2021-02-26;0;0;0;0
FR;4;2021-02-27;0;0;0;0
FR;4;2021-02-28;0;0;0;0
FR;4;2021-03-01;0;0;0;0
FR;4;2021-03-02;0;0;0;0
FR;4;2021-03-03;0;0;0;0
FR;4;2021-03-04;0;0;0;0
FR;4;2021-03-05;0;0;0;0
FR;4;2021-03-06;0;0;0;0
FR;4;2021-03-07;0;0;0;0
FR;4;2021-03-08;0;0;0;0
FR;4;2021-03-09;0;0;0;0
FR;4;2021-03-10;0;0;0;0
FR;4;2021-03-11;0;0;0;0
FR;4;2021-03-12;0;0;0;0
FR;4;2021-03-13;0;0;0;0
FR;4;2021-03-14;0;0;0;0
FR;4;2021-03-15;0;0;0;0
FR;4;2021-03-16;0;0;0;0
FR;4;2021-03-17;0;0;0;0
FR;4;2021-03-18;0;0;0;0
FR;4;2021-03-19;0;0;0;0
FR;4;2021-03-20;0;0;0;0
FR;4;2021-03-21;0;0;0;0
FR;4;2021-03-22;0;0;0;0
FR;4;2021-03-23;0;0;0;0
FR;4;2021-03-24;0;0;0;0
FR;4;2021-03-25;0;0;0;0
FR;4;2021-03-26;0;0;0;0
FR;4;2021-03-27;0;0;0;0
FR;4;2021-03-28;0;0;0;0
FR;4;2021-03-29;0;0;0;0
FR;4;2021-03-30;0;0;0;0
FR;4;2021-03-31;0;0;0;0
FR;4;2021-04-01;0;0;0;0
FR;4;2021-04-02;0;0;0;0
FR;4;2021-04-03;0;0;0;0
FR;4;2021-04-04;0;0;0;0
FR;4;2021-04-05;0;0;0;0
FR;4;2021-04-06;0;0;0;0
FR;4;2021-04-07;0;0;0;0
FR;4;2021-04-08;0;0;0;0
FR;4;2021-04-09;0;0;0;0
FR;4;2021-04-10;0;0;0;0
FR;4;2021-04-11;0;0;0;0
FR;4;2021-04-12;0;0;0;0
FR;4;2021-04-13;0;0;0;0
FR;4;2021-04-14;0;0;0;0
FR;4;2021-04-15;0;0;0;0
FR;4;2021-04-16;0;0;0;0
FR;4;2021-04-17;0;0;0;0
FR;4;2021-04-18;0;0;0;0
FR;4;2021-04-19;0;0;0;0
FR;4;2021-04-20;0;0;0;0
FR;4;2021-04-21;0;0;0;0
FR;4;2021-04-22;0;0;0;0
FR;4;2021-04-23;397;0;397;0
FR;4;2021-04-24;1483;0;1880;0
FR;0;2020-12-27;17;0;17;0
FR;0;2020-12-28;59;0;76;0
FR;0;2020-12-29;107;0;183;0
FR;0;2020-12-30;115;0;298;0
FR;0;2020-12-31;83;0;381;0
FR;0;2021-01-01;55;0;436;0
FR;0;2021-01-02;71;0;507;0
FR;0;2021-01-03;87;0;594;0
FR;0;2021-01-04;1462;0;2056;0
FR;0;2021-01-05;5352;0;7408;0
FR;0;2021-01-06;11247;0;18655;0
FR;0;2021-01-07;28447;0;47102;0
FR;0;2021-01-08;35878;0;82980;0
FR;0;2021-01-09;10865;0;93845;0
FR;0;2021-01-10;5599;0;99444;0
FR;0;2021-01-11;38711;0;138155;0
FR;0;2021-01-12;60303;0;198458;0
FR;0;2021-01-13;63328;0;261786;0
FR;0;2021-01-14;79419;0;341205;0
FR;0;2021-01-15;66872;0;408077;0
FR;0;2021-01-16;19571;651;427648;651
FR;0;2021-01-17;10446;40;438094;691
FR;0;2021-01-18;84057;187;522151;878
FR;0;2021-01-19;127744;227;649895;1105
FR;0;2021-01-20;134502;154;784397;1259
FR;0;2021-01-21;154501;156;938898;1415
FR;0;2021-01-22;117871;222;1056769;1637
FR;0;2021-01-23;37710;83;1094479;1720
FR;0;2021-01-24;9315;104;1103794;1824
FR;0;2021-01-25;76555;1498;1180349;3322
FR;0;2021-01-26;98243;3923;1278592;7245
FR;0;2021-01-27;105314;6795;1383906;14040
FR;0;2021-01-28;121774;17505;1505680;31545
FR;0;2021-01-29;90600;19612;1596280;51157
FR;0;2021-01-30;28594;4660;1624874;55817
FR;0;2021-01-31;4855;1907;1629729;57724
FR;0;2021-02-01;51340;24110;1681069;81834
FR;0;2021-02-02;70277;40618;1751346;122452
FR;0;2021-02-03;70742;41851;1822088;164303
FR;0;2021-02-04;80045;58541;1902133;222844
FR;0;2021-02-05;66733;49446;1968866;272290
FR;0;2021-02-06;21206;11374;1990072;283664
FR;0;2021-02-07;4810;6447;1994882;290111
FR;0;2021-02-08;45692;50008;2040574;340119
FR;0;2021-02-09;64500;82171;2105074;422290
FR;0;2021-02-10;68832;87139;2173906;509429
FR;0;2021-02-11;84977;109869;2258883;619298
FR;0;2021-02-12;77156;75551;2336039;694849
FR;0;2021-02-13;21535;18651;2357574;713500
FR;0;2021-02-14;4539;6747;2362113;720247
FR;0;2021-02-15;36743;74955;2398856;795202
FR;0;2021-02-16;48791;96415;2447647;891617
FR;0;2021-02-17;49013;107735;2496660;999352
FR;0;2021-02-18;67181;125226;2563841;1124578
FR;0;2021-02-19;63213;90798;2627054;1215376
FR;0;2021-02-20;17848;27636;2644902;1243012
FR;0;2021-02-21;2836;5380;2647738;1248392
FR;0;2021-02-22;36131;70695;2683869;1319087
FR;0;2021-02-23;52079;83515;2735948;1402602
FR;0;2021-02-24;57536;82443;2793484;1485045
FR;0;2021-02-25;97505;88490;2890989;1573535
FR;0;2021-02-26;110628;68919;3001617;1642454
FR;0;2021-02-27;50602;22056;3052219;1664510
FR;0;2021-02-28;5616;3572;3057835;1668082
FR;0;2021-03-01;62855;52394;3120690;1720476
FR;0;2021-03-02;98399;66232;3219089;1786708
FR;0;2021-03-03;112271;64196;3331360;1850904
FR;0;2021-03-04;157766;72989;3489126;1923893
FR;0;2021-03-05;195451;61045;3684577;1984938
FR;0;2021-03-06;201954;16715;3886531;2001653
FR;0;2021-03-07;118775;2390;4005306;2004043
FR;0;2021-03-08;103769;46740;4109075;2050783
FR;0;2021-03-09;168003;53896;4277078;2104679
FR;0;2021-03-10;173931;55535;4451009;2160214
FR;0;2021-03-11;236926;62905;4687935;2223119
FR;0;2021-03-12;288219;51824;4976154;2274943
FR;0;2021-03-13;226242;14702;5202396;2289645
FR;0;2021-03-14;61911;2445;5264307;2292090
FR;0;2021-03-15;154631;29298;5418938;2321388
FR;0;2021-03-16;138754;36991;5557692;2358379
FR;0;2021-03-17;147237;35783;5704929;2394162
FR;0;2021-03-18;164213;42644;5869142;2436806
FR;0;2021-03-19;225208;34873;6094350;2471679
FR;0;2021-03-20;163821;10833;6258171;2482512
FR;0;2021-03-21;48632;1489;6306803;2484001
FR;0;2021-03-22;166161;31866;6472964;2515867
FR;0;2021-03-23;245462;40782;6718426;2556649
FR;0;2021-03-24;252016;42072;6970442;2598721
FR;0;2021-03-25;335495;44204;7305937;2642925
FR;0;2021-03-26;352660;40328;7658597;2683253
FR;0;2021-03-27;192038;16597;7850635;2699850
FR;0;2021-03-28;57640;4721;7908275;2704571
FR;0;2021-03-29;198184;51403;8106459;2755974
FR;0;2021-03-30;278141;68882;8384600;2824856
FR;0;2021-03-31;255860;73235;8640460;2898091
FR;0;2021-04-01;303678;93151;8944138;2991242
FR;0;2021-04-02;274321;95189;9218459;3086431
FR;0;2021-04-03;137784;62348;9356243;3148779
FR;0;2021-04-04;44511;18852;9400754;3167631
FR;0;2021-04-05;58301;9767;9459055;3177398
FR;0;2021-04-06;206617;112803;9665672;3290201
FR;0;2021-04-07;251896;113348;9917568;3403549
FR;0;2021-04-08;326648;121645;10244216;3525194
FR;0;2021-04-09;398759;115354;10642975;3640548
FR;0;2021-04-10;208494;81841;10851469;3722389
FR;0;2021-04-11;54632;33464;10906101;3755853
FR;0;2021-04-12;230790;113317;11136891;3869170
FR;0;2021-04-13;300752;140259;11437643;4009429
FR;0;2021-04-14;285274;137079;11722917;4146508
FR;0;2021-04-15;325737;146213;12048654;4292721
FR;0;2021-04-16;328597;143568;12377251;4436289
FR;0;2021-04-17;184218;88656;12561469;4524945
FR;0;2021-04-18;49957;35038;12611426;4559983
FR;0;2021-04-19;198652;135430;12810078;4695413
FR;0;2021-04-20;245109;168027;13055187;4863440
FR;0;2021-04-21;241529;166228;13296716;5029668
FR;0;2021-04-22;273207;184714;13569923;5214382
FR;0;2021-04-23;278684;178781;13848607;5393163
FR;0;2021-04-24;184140;109231;14032747;5502394
